ID,damage,kills,rifle,sniper,pistol,smg,grenade,preplant kill,postplant kill,fast_kill_rating (first_kill),total kills,total deaths,avg kill time,assists
76561198152153688,1676,12,10,2,0,0,0,9,3,3,12,11,208.5647727272727,12
76561198115686363,1203,13,9,0,0,3,1,12,1,5,13,10,199.24014166666666,7
76561198062948330,863,6,1,2,2,1,0,5,1,4,6,10,432.77666,7
76561198255072271,1045,9,4,0,2,3,0,8,1,5,9,11,272.48175000000003,10
76561198073535347,1922,22,7,13,1,1,0,22,0,5,22,8,88.1382619047619,2
76561198355692407,1910,18,3,15,0,0,0,18,0,5,18,12,142.0153235294118,6
76561198324785976,845,6,1,0,1,4,0,5,1,4,6,13,453.23562000000004,6
76561198370068230,912,5,0,1,1,3,0,5,0,3,5,14,516.0063250000001,9
76561198301910020,975,10,9,0,1,0,0,10,0,5,10,12,206.1595111111111,4
76561198237972336,903,11,7,0,3,1,0,6,5,5,11,11,172.473,4
76561198072474628,239,4,2,0,0,2,0,2,2,4,4,3,417.1073666666666,2
76561198239152652,429,11,7,0,0,4,0,10,1,5,11,4,111.03450000000001,2
76561198140201574,1037,10,10,0,0,0,0,10,0,5,10,4,123.07994444444444,5
76561198231962156,671,5,2,2,0,1,0,4,1,5,5,4,268.65409999999997,4
76561198203426961,818,19,19,0,0,0,0,19,0,4,19,3,60.41464444444445,2
76561198153723042,265,2,0,2,0,0,0,2,0,5,2,6,737.9579999999999,2
76561198196759934,716,6,4,0,0,2,0,6,0,3,6,12,233.81599999999997,3
76561198274581240,450,3,3,0,0,0,0,3,0,5,3,7,576.4127,3
76561198092508516,716,7,5,0,0,0,0,5,2,4,7,23,208.7986,5
76561198171272366,9,1,0,0,1,0,0,1,0,3,1,2,0.0,0
76561198338833710,1114,6,3,1,1,0,0,5,1,5,6,12,353.5851799999999,11
76561198108350875,934,10,3,7,0,0,0,8,2,2,10,8,222.06515555555555,3
76561198375458023,1591,14,3,8,0,2,0,12,2,4,14,10,142.5265846153846,7
76561198337761088,1185,12,4,3,0,3,0,10,2,4,12,12,165.80091818181816,4
76561198350805205,513,5,1,2,0,0,0,5,0,5,5,11,323.6120000000001,3
76561198381263623,1096,10,10,0,0,0,0,8,2,2,10,8,190.8207888888889,8
76561198094744430,1426,17,13,4,0,0,0,13,4,5,17,9,128.19732499999998,4
76561198023317027,1147,9,7,1,0,0,1,9,0,3,9,9,249.60451250000008,5
76561198240406968,572,5,4,1,0,0,0,4,1,5,5,10,404.67895000000004,6
76561198347812567,1351,11,7,0,0,3,1,11,0,3,11,10,182.74045,7
76561198004349810,637,4,4,0,0,0,0,4,0,5,4,9,269.88809999999995,4
76561198218834683,806,8,2,6,0,0,0,6,2,5,8,8,170.47890000000004,5
76561198002090355,817,8,6,2,0,0,0,8,0,4,8,7,211.09702857142858,5
76561198052089770,774,5,4,1,0,0,0,4,1,4,5,8,399.26867500000003,7
76561197973694700,947,9,9,0,0,0,0,9,0,3,9,8,194.2857125,3
76561198265125607,844,6,3,1,2,0,0,3,3,3,6,7,323.29682,9
76561198289131921,911,8,7,0,0,0,1,5,3,5,8,7,190.12495714285714,5
76561198273673499,1111,14,4,3,7,0,0,13,1,5,14,6,117.1971076923077,1
76561198201955028,470,4,3,0,0,1,0,4,0,5,4,8,212.8473333333333,3
76561198130725984,850,8,5,0,3,0,0,5,3,2,8,6,226.8765142857143,6
76561198351330082,239,3,0,0,0,3,0,3,0,5,3,3,0.14080000000001291,2
76561198160354649,387,4,1,1,0,2,0,4,0,4,4,1,147.01430000000002,0
76561198398366067,310,4,0,0,0,4,0,3,1,3,4,2,120.08723333333334,2
76561198165650154,515,6,6,0,0,0,0,6,0,5,6,2,49.67638000000004,1
76561198257314740,326,5,5,0,0,0,0,5,0,5,5,2,50.355275000000006,0
76561198004501014,126,0,0,0,0,0,0,0,0,0,0,4,0.0,3
76561198105611916,301,4,4,0,0,0,0,3,1,5,4,3,144.44883333333334,3
76561198273962443,555,4,1,0,0,3,0,3,1,5,4,4,124.45686666666666,2
76561198011691579,17,0,0,0,0,0,0,0,0,0,0,2,0.0,1
76561198012411246,302,2,1,0,0,1,0,2,0,4,2,9,335.92099999999994,2
76561198354863279,336,3,1,0,1,1,0,3,0,5,3,8,364.8760000000001,2
76561198107577184,515,6,2,2,1,0,0,5,1,4,6,7,173.16792,2
76561198130877966,754,8,8,0,0,0,0,4,4,5,8,7,128.57410000000002,5
76561198362206489,697,6,4,1,0,1,0,6,0,4,6,6,147.1011,2
76561198252651356,540,3,1,2,0,0,0,3,0,5,3,7,367.56515,4
76561198304422673,375,2,2,0,0,0,0,2,0,5,2,7,116.26260000000002,4
76561198350397203,673,7,4,3,0,0,0,4,3,4,7,4,148.70533333333333,2
76561198282050775,769,6,6,0,0,0,0,5,1,3,6,5,171.7672,3
76561198232256732,1001,10,9,1,0,0,0,9,1,4,10,4,85.34323333333333,3
76561198189342227,995,10,8,0,2,0,0,8,2,5,10,6,72.01526666666665,1
76561198098776450,1072,9,7,0,2,0,0,8,1,5,9,7,192.2336125,6
76561198141423088,1008,11,1,9,1,0,0,9,2,5,11,6,165.76865,6
76561198222563524,1000,11,8,0,1,2,0,5,6,5,11,4,185.02438,3
76561197973138976,410,3,0,0,0,3,0,2,1,4,3,8,650.85235,5
76561198163229386,667,5,2,0,2,0,0,3,2,4,5,6,278.318,6
76561198121019442,889,7,5,0,0,2,0,7,0,4,7,8,275.3954666666668,5
76561198200132158,895,9,0,4,4,1,0,8,1,5,9,8,230.022325,3
76561198342010381,447,3,3,0,0,0,0,2,1,5,3,7,524.142,6
76561198218888429,497,5,3,1,1,0,0,4,1,3,5,8,412.88975,5
76561198351614009,693,5,3,0,2,0,0,2,3,4,5,6,376.70709999999997,6
76561198050911985,1141,14,9,2,3,0,0,10,4,5,14,4,175.49041538461537,1
76561198240900414,1039,14,9,3,2,0,0,8,6,5,14,6,164.6046076923077,5
76561198322385748,911,7,5,0,0,2,0,6,1,4,7,13,363.9774333333333,7
76561197987779161,744,6,1,1,1,3,0,4,2,5,6,8,355.1201,6
76561198143322388,618,14,3,1,0,10,0,14,0,4,14,7,162.84960769230767,3
76561198273215840,1205,12,10,1,0,1,0,11,1,5,12,17,189.00365454545454,5
76561198197075883,1257,12,11,1,0,0,0,12,0,4,12,11,204.67017272727273,7
76561198008906339,648,8,6,0,0,2,0,7,1,3,8,13,281.64702857142856,4
76561198201226531,655,7,5,0,0,2,0,6,1,3,7,12,192.91174999999998,2
76561198505695774,76,0,0,0,0,0,0,0,0,0,0,3,0.0,2
76561198323615998,522,5,0,5,0,0,0,5,0,5,5,5,300.39275,1
76561198217364244,707,8,1,6,1,0,0,8,0,5,8,3,170.09019999999995,3
76561198129930965,973,9,2,5,2,0,0,6,3,4,9,4,150.899675,6
76561198178182678,732,7,6,0,0,1,0,7,0,5,7,3,129.76410000000007,4
76561198113349550,207,1,0,1,0,0,0,0,1,5,1,4,0.0,2
76561198364924235,506,4,3,1,0,0,0,3,1,5,4,7,186.36846666666668,6
76561198084363685,270,2,1,1,0,0,0,2,0,4,2,6,14.315200000000004,3
76561197961944679,564,5,4,0,1,0,0,4,1,5,5,5,134.072175,4
76561198360088421,612,6,3,2,1,0,0,6,0,5,6,5,187.09792,3
76561198112707955,311,2,0,0,0,0,0,2,0,5,2,7,10.876999999999953,2
76561198103161129,481,3,3,0,0,0,0,3,0,4,3,4,278.5590000000002,3
76561198049825612,299,3,0,2,0,0,1,3,0,4,3,2,287.9192,2
76561197985776228,302,2,1,1,0,0,0,2,0,3,2,2,545.9279999999999,2
76561198234094956,295,4,3,0,0,0,0,3,1,4,4,2,358.04466666666667,0
76561198115889577,416,5,2,3,0,0,0,4,1,5,5,2,153.89075000000003,0
76561198324350955,201,2,1,0,0,1,0,1,1,3,2,3,860.4144,2
76561198351970085,351,4,0,3,1,0,0,3,1,5,4,3,371.0571,2
76561198320321125,271,2,2,0,0,0,0,2,0,5,2,4,8.970199999999977,1
76561198287952829,280,2,0,2,0,0,0,2,0,5,2,4,19.314999999999827,1
76561198041539273,284,2,2,0,0,0,0,2,0,4,2,3,548.0840000000001,1
76561198181334318,1259,12,10,2,0,0,0,9,3,5,12,11,243.69748181818184,5
76561198057256997,1812,15,13,1,0,1,0,10,5,4,15,9,168.55616428571426,10
76561198273962674,2006,19,18,0,0,0,1,15,4,4,19,9,146.25025555555555,7
76561198066317190,578,6,2,2,0,0,0,6,0,5,6,14,461.49868000000004,4
76561198083280914,634,5,0,4,1,0,0,4,1,5,5,13,38.548,7
76561198271873925,1696,13,10,1,0,1,0,12,1,5,13,11,223.85815833333334,10
76561198162090745,1087,9,9,0,0,0,0,7,2,3,9,11,327.4299625000001,5
76561198061520031,1592,14,8,1,3,1,0,12,2,3,14,11,203.53423846153845,7
76561198203831271,1311,13,11,1,1,0,0,11,2,5,13,10,210.57917500000008,7
76561198268643206,798,7,5,0,1,1,0,6,1,5,7,14,397.4654833333334,6
76561197967729203,1082,10,8,0,0,1,1,10,0,4,10,6,206.9145666666667,5
76561198414606641,757,11,3,5,0,2,1,10,1,4,11,6,182.62804999999997,1
76561198395557630,767,9,8,0,0,1,0,8,1,5,9,6,225.18235000000007,5
76561198360374468,482,2,0,0,0,2,0,2,0,5,2,6,230.9929999999997,8
76561198404021902,728,4,1,2,0,1,0,4,0,5,4,7,579.4888,6
76561198076100521,958,11,8,1,1,1,0,9,2,5,11,7,182.10599000000002,2
76561198035344213,898,10,2,8,0,0,0,10,0,5,10,7,209.0890111111111,3
76561198089041153,523,4,3,1,0,0,0,4,0,5,4,8,306.93833333333333,3
76561198351364867,417,2,2,0,0,0,0,2,0,5,2,8,1319.0280000000002,4
76561198023317027,359,4,3,0,0,1,0,2,2,5,4,6,395.805,2
76561198076100521,2370,21,16,2,0,3,0,19,2,5,21,12,111.67909,10
76561198016696018,515,4,4,0,0,0,0,3,1,5,4,12,596.8996333333333,7
76561198023317027,775,7,6,0,1,0,0,7,0,4,7,12,395.3764833333333,8
76561198025933652,1524,16,4,11,1,0,0,13,3,4,16,11,142.96993333333336,9
76561197984342751,1302,12,6,5,1,0,0,9,3,5,12,15,196.01337272727275,6
76561198258350518,1060,8,8,0,0,0,0,8,0,5,8,14,318.0113714285714,8
76561198379026549,1608,15,8,5,2,0,0,13,2,5,15,13,153.0793571428572,8
76561198116645372,1509,14,13,0,0,1,0,13,1,4,14,14,160.67763076923077,11
76561198385481594,1133,10,8,0,0,2,0,10,0,5,10,8,220.86004444444447,4
76561198060633517,1290,15,10,0,0,5,0,13,2,5,15,11,170.24425,3
76561198213441832,1655,13,12,0,0,1,0,12,1,5,13,11,187.61658333333332,9
76561198254084819,1124,10,6,4,0,0,0,10,0,5,10,9,250.3116666666667,6
76561198176890349,1162,10,9,1,0,0,0,8,2,4,10,9,251.07565555555564,10
76561198086233264,1207,13,12,0,1,0,0,11,2,4,13,13,154.30564166666667,5
76561198048297052,1200,12,11,0,1,0,0,9,3,3,12,9,206.92566363636362,6
76561198073585417,988,7,1,5,0,1,0,7,0,4,7,11,382.3901333333333,9
76561197975648030,856,6,6,0,0,0,0,5,1,4,6,13,450.9234399999999,8
76561198043489577,970,7,3,4,0,0,0,4,3,5,7,12,283.94210000000004,8
76561198168699351,1626,19,19,0,0,0,0,18,1,5,19,10,112.57632222222225,8
76561198280393439,1483,12,12,0,0,0,0,11,1,5,12,12,211.6563181818182,11
76561198320775734,765,4,1,2,0,1,0,4,0,5,4,8,462.62113333333326,5
76561198390246135,700,7,4,2,1,0,0,6,1,4,7,9,245.25609999999998,3
76561198388246513,725,4,1,0,0,2,0,4,0,5,4,9,97.22266666666663,8
76561198243727468,705,6,0,2,3,1,0,5,1,4,6,7,224.71095999999997,5
76561198262818304,489,5,4,0,0,1,0,5,0,4,5,8,333.731575,2
76561198347189514,918,13,5,4,4,0,0,10,3,5,13,5,123.01888333333333,2
76561198376752383,1045,7,7,0,0,0,0,6,1,5,7,8,114.14928333333334,8
76561198173503747,621,6,5,1,0,0,0,6,0,4,6,7,238.85042000000004,5
76561198367311872,551,6,6,0,0,0,0,5,1,5,6,4,298.84742,5
76561198101908730,1066,11,9,2,0,0,0,10,1,3,11,4,130.46909,3
76561198097008118,627,8,4,4,0,0,0,8,0,5,8,13,334.8110571428571,2
76561198359485055,928,5,3,2,0,0,0,5,0,5,5,9,299.17094999999995,8
76561198115840526,1848,24,22,0,0,1,1,19,5,5,24,8,99.69506086956521,4
76561198322317350,955,8,5,2,0,1,0,7,1,4,8,7,271.6321857142857,5
76561198320915106,739,9,7,1,0,1,0,9,0,3,9,10,289.7992625,1
76561198261026325,1506,15,7,2,3,3,0,14,1,4,15,17,161.77563571428573,5
76561198334411310,508,5,3,2,0,0,0,3,2,5,5,5,459.425475,2
76561198058437126,859,7,7,0,0,0,0,6,1,5,7,11,262.5981666666667,8
76561198057844686,1493,16,2,11,0,3,0,16,0,5,16,10,149.44256000000001,4
76561198158615419,713,4,2,0,2,0,0,4,0,5,4,11,546.583,7
76561198172918237,1051,11,6,1,1,3,0,10,1,4,11,6,195.45405,4
76561198126696303,914,10,10,0,0,0,0,10,0,5,10,8,213.5733888888889,3
76561198036336873,971,14,11,3,0,0,0,11,3,3,14,6,145.45433846153847,4
76561198367555158,536,8,6,0,0,2,0,8,0,5,8,6,148.75428571428571,4
76561198034068025,343,3,3,0,0,0,0,2,1,5,3,5,677.4285000000003,3
76561198101762264,1476,15,11,4,0,0,0,14,1,5,15,17,120.91304285714286,5
76561198204766729,271,2,0,2,0,0,0,2,0,5,2,2,53.41420000000005,1
76561198082045091,547,3,2,0,0,1,0,3,0,4,3,9,447.22285,8
76561198331671711,502,3,2,1,0,0,0,3,0,5,3,13,913.464,4
76561198171306534,834,9,9,0,0,0,0,7,2,5,9,6,60.821499999999986,3
76561198373044773,665,5,5,0,0,0,0,5,0,5,5,7,418.96662499999996,5
76561198058437126,409,4,4,0,0,0,0,0,4,5,4,7,8.721666666666655,3
76561198122538986,401,2,1,0,0,1,0,2,0,4,2,7,1591.9960000000008,3
76561198369427260,129,1,1,0,0,0,0,1,0,5,1,7,0.0,3
76561198271592151,872,9,6,1,0,2,0,8,1,4,9,7,214.809175,2
76561198413216924,789,5,4,1,0,0,0,2,3,4,5,5,168.74790000000002,6
76561198391145115,749,8,2,4,2,0,0,7,1,5,8,4,255.76272857142857,3
76561198097291395,1180,14,12,2,0,0,0,9,5,5,14,3,133.65705384615384,3
76561198204060507,394,4,4,0,0,0,0,4,0,5,4,5,178.212,5
76561198274241592,537,4,4,0,0,0,0,4,0,5,4,4,297.19700000000006,5
76561198107949630,874,6,4,2,0,0,0,6,0,5,6,10,184.14281999999997,6
76561198339677808,870,9,7,0,0,2,0,9,0,4,9,8,209.3005875,2
76561198159006794,935,9,2,6,1,0,0,9,0,3,9,8,112.1156375,4
76561198080849199,480,3,1,1,0,1,0,2,1,5,3,7,310.979,5
76561198252584168,435,5,4,0,1,0,0,4,1,5,5,9,167.45455,3
76561198321805153,763,8,3,5,0,0,0,8,0,5,8,6,94.70588571428571,5
76561198120043730,945,8,4,3,0,0,1,7,1,5,8,7,253.93772857142858,5
76561198056165293,1027,11,7,2,2,0,0,11,0,4,11,6,175.06485999999998,3
76561198120296440,661,6,6,0,0,0,0,6,0,5,6,7,252.57838,6
76561198265845129,919,9,9,0,0,0,0,7,2,5,9,6,203.8222,5
76561197960973277,1433,15,7,7,0,0,1,11,4,5,15,7,164.12170714285713,4
76561198238918896,600,4,3,1,0,0,0,2,2,5,4,9,407.1733333333334,7
76561198273483344,657,6,2,3,0,1,0,6,0,5,6,9,298.60574,3
76561198062438980,1012,8,8,0,0,0,0,7,1,5,8,9,194.1308571428571,6
76561198170631263,429,7,6,0,0,0,1,4,3,5,7,9,209.11083333333332,1
76561198275875931,325,1,1,0,0,0,0,1,0,5,1,8,0.0,4
76561197998694956,880,9,4,1,0,4,0,7,2,5,9,7,201.82925,6
76561198165446767,615,5,5,0,0,0,0,4,1,5,5,10,398.36609999999996,4
76561198086068658,1153,15,11,2,1,0,0,9,6,4,15,9,160.56147142857142,2
76561198022810052,1480,13,8,4,1,0,0,11,2,4,13,6,184.25994166666666,4
76561198232635956,1482,12,5,3,1,3,0,9,3,4,12,16,162.2471090909091,8
76561198162929921,2292,23,15,7,1,0,0,17,6,5,23,15,92.3124,5
76561198340346186,98,1,0,1,0,0,0,1,0,5,1,0,0.0,0
76561198125654826,1544,14,13,0,0,1,0,13,1,5,14,16,139.83196923076923,5
76561198139187803,1074,12,7,0,0,5,0,9,3,5,12,7,146.5207090909091,2
76561198283337466,1084,11,6,5,0,0,0,8,3,4,11,13,162.36668,6
76561198367626942,873,9,3,2,4,0,0,8,1,5,9,15,172.29835000000003,7
76561198362346049,432,3,1,0,0,2,0,2,1,4,3,12,508.09340000000003,4
76561198086722398,1065,18,15,0,0,3,0,9,9,3,18,10,108.47465294117649,5
76561198316135805,1241,13,7,4,0,2,0,10,3,5,13,12,124.86161666666668,5
76561198159402850,706,8,7,0,0,0,0,7,1,5,8,6,283.73102857142857,1
76561197960621802,765,5,4,0,0,1,0,4,1,4,5,7,278.738475,8
76561198013879729,571,5,1,4,0,0,0,4,1,4,5,8,474.5463,5
76561198106307138,625,4,2,1,0,0,0,2,2,5,4,8,587.6315333333333,6
76561198054164023,1045,12,6,0,6,0,0,10,2,5,12,7,164.52867272727272,6
76561198065350259,919,6,4,2,0,0,0,5,1,5,6,9,375.93596,6
76561198078958929,861,9,0,5,3,1,0,6,3,4,9,4,227.75076249999998,2
76561198155115183,789,11,10,0,0,0,0,9,2,5,11,5,190.34051,2
76561198084109980,936,6,2,0,1,0,0,5,1,5,6,8,366.78326,8
76561198104645848,455,4,3,0,1,0,0,4,0,4,4,8,563.3223666666667,2
76561198259095958,1029,10,9,1,0,0,0,6,4,5,10,6,238.1285,4
76561198364082220,975,10,9,0,0,1,0,7,3,5,10,6,249.7227777777778,4
76561198121862709,676,6,5,1,0,0,0,6,0,4,6,6,517.28096,4
76561198306303298,970,9,0,8,0,0,0,8,1,5,9,7,312.24213750000007,2
76561198047953325,743,6,5,0,0,1,0,4,2,3,6,6,437.68436,5
76561198136756225,1357,14,4,9,0,1,0,10,4,5,14,8,197.95873076923078,4
76561198005010318,447,4,4,0,0,0,0,4,0,5,4,8,533.5096666666667,6
76561198265845129,825,4,4,0,0,0,0,2,2,4,4,9,239.1982,8
76561198129438369,657,6,3,1,1,1,0,5,1,5,6,9,266.33700000000005,3
76561198228247336,379,3,1,0,2,0,0,2,1,5,3,7,156.94535000000002,3
76561198087114739,1010,11,4,7,0,0,0,9,2,5,11,6,160.90304,2
76561197979945083,829,8,5,3,0,0,0,5,3,5,8,7,308.17298571428574,4
76561198034991732,1362,10,10,0,0,0,0,10,0,5,10,13,202.43132222222232,8
76561198041338282,764,7,5,0,0,2,0,4,3,5,7,9,298.4785666666667,4
76561198075953855,1389,14,9,4,1,0,0,12,2,3,14,9,159.37224615384613,3
76561198068766505,655,5,5,0,0,0,0,4,1,5,5,12,235.61674999999997,7
76561198081647334,610,7,6,1,0,0,0,4,3,5,7,8,249.4676333333333,4
76561198067129530,1724,16,3,12,0,0,0,10,6,4,16,9,142.51154,5
76561198021383627,917,7,6,0,0,1,0,6,1,4,7,12,352.4234166666667,8
76561198051935509,751,9,5,3,1,0,0,6,3,5,9,9,235.20637500000004,4
76561198100601368,745,7,7,0,0,0,0,7,0,4,7,8,303.4096333333333,5
76561198115467219,420,3,2,0,1,0,0,3,0,5,3,8,648.7950000000001,4
76561198279538048,604,6,2,4,0,0,0,6,0,5,6,7,266.16358,2
76561198076372101,463,5,1,4,0,0,0,4,1,3,5,7,331.82145,3
76561198265845129,467,1,1,0,0,0,0,0,1,5,1,7,0.0,6
76561198219551523,1093,9,2,7,0,0,0,9,0,3,9,5,158.463225,4
76561198149765709,825,8,6,0,0,0,1,7,1,5,8,4,195.72115714285715,4
76561198138250334,423,2,1,0,0,1,0,2,0,5,2,7,1583.5776999999998,6
76561198192048041,656,9,6,1,0,0,2,7,2,4,9,4,232.2030875,1
76561198337951914,792,9,8,0,1,0,0,7,2,5,9,2,206.62154999999996,2
76561198081052806,1312,8,5,0,2,1,0,7,1,5,8,12,335.4574428571429,11
76561198061013450,1114,9,8,0,0,1,0,7,2,4,9,12,332.78205,8
76561197999633886,1192,13,3,7,3,0,0,12,1,4,13,9,182.3231916666667,5
76561198210943537,2013,21,8,11,2,0,0,16,5,4,21,9,120.28842999999999,7
76561198113386942,1389,15,15,0,0,0,0,13,2,3,15,14,170.63295714285718,4
76561198061432075,920,9,6,0,3,0,0,6,3,5,9,13,305.07692499999996,6
76561198235336312,1304,13,4,8,1,0,0,9,4,5,13,14,207.79120000000003,8
76561197982169130,1111,10,4,0,3,2,1,10,0,5,10,14,258.02222222222224,10
76561198068705444,1469,13,5,6,1,1,0,12,1,5,13,13,200.39485,5
76561198068466018,1514,11,11,0,0,0,0,8,3,5,11,12,102.71997999999999,10
76561198052547531,1526,15,13,2,0,0,0,13,2,5,15,9,149.03927142857145,6
76561198078682846,723,5,4,0,0,1,0,3,2,5,5,12,531.106975,11
76561197993282442,1245,9,8,0,0,1,0,6,3,4,9,11,258.4982125,13
76561198318381873,859,9,6,1,2,0,0,4,5,5,9,11,186.69812499999998,8
76561197994500135,810,7,6,0,0,1,0,6,1,3,7,13,357.54043333333334,13
76561198119073008,1301,12,4,5,1,1,1,8,4,5,12,10,196.68700909090919,10
76561198033779178,885,11,9,0,0,2,0,9,2,5,11,9,224.40337000000005,4
76561198125049991,2340,19,19,0,0,0,0,15,4,4,19,11,134.2094,13
76561198090171024,1158,9,7,0,1,0,1,7,2,3,9,8,290.661475,11
76561198012613216,644,7,5,0,0,2,0,5,2,5,7,9,219.66750000000002,6
76561198077980045,1390,13,3,8,2,0,0,12,1,5,13,8,147.90297499999997,4
76561197970263527,500,3,1,0,0,2,0,3,0,5,3,9,656.08145,8
76561198093078274,994,11,11,0,0,0,0,10,1,4,11,7,208.64515,4
76561198000743634,1592,16,14,1,1,0,0,10,6,5,16,4,130.97035333333332,5
76561197986940223,967,9,4,1,2,2,0,9,0,5,9,9,210.1884,4
76561198108099010,686,6,5,1,0,0,0,5,1,5,6,12,224.71986000000007,6
76561198095819573,1455,14,12,2,0,0,0,12,2,5,14,11,133.06123076923075,6
76561198180116511,598,4,1,1,2,0,0,4,0,4,4,9,696.6820333333334,7
76561198274682562,1125,10,6,4,0,0,0,9,1,5,10,10,206.68471111111114,4
76561198329429828,652,3,3,0,0,0,0,3,0,5,3,10,323.30549999999994,6
76561198176318747,1218,12,12,0,0,0,0,7,5,5,12,8,129.2332818181818,6
76561198307205737,947,9,0,6,1,2,0,7,2,4,9,7,176.71511250000003,3
76561198131033588,873,7,3,0,0,4,0,7,0,4,7,10,263.38669999999996,8
76561198199070657,1378,15,13,0,0,1,1,10,5,3,15,6,124.67952142857142,6
76561198336643960,652,4,1,1,0,1,0,4,0,5,4,9,517.1253666666667,7
76561198348123679,1205,11,4,4,0,3,0,7,4,5,11,9,176.22668000000002,6
76561198268297925,879,8,7,0,0,1,0,3,5,4,8,9,215.87392857142854,3
76561198166584862,1082,11,7,4,0,0,0,8,3,5,11,9,147.77347000000003,4
76561198376252239,683,6,3,0,2,1,0,5,1,5,6,11,245.59840000000003,3
76561198140579151,558,4,3,0,0,1,0,4,0,5,4,9,169.8294,5
76561198158133802,1120,14,6,6,2,0,0,12,2,5,14,9,151.34166923076924,4
76561198033540813,760,5,3,1,1,0,0,2,3,5,5,8,395.546425,10
76561198294645154,1220,11,9,2,0,0,0,8,3,4,11,11,187.83631000000003,7
76561198275015619,820,6,1,0,1,3,1,6,0,5,6,12,340.28520000000003,8
76561198053734769,1481,11,10,0,0,1,0,9,2,5,11,8,142.744,9
76561198124045152,1710,17,8,3,2,3,1,14,3,5,17,7,127.48345625000002,6
76561198038850021,828,8,6,1,1,0,0,6,2,5,8,11,305.1656142857143,6
76561198191572719,833,8,3,2,0,3,0,8,0,5,8,8,197.49028571428576,6
76561198225663472,700,5,1,0,0,4,0,5,0,4,5,11,473.32590000000005,7
76561198192041083,770,9,9,0,0,0,0,7,2,5,9,9,196.40582500000002,4
76561197978862684,1877,16,3,11,0,2,0,13,3,5,16,8,168.44546666666668,7
76561198269000606,1322,15,5,7,0,1,2,9,6,5,15,10,144.47650714285712,9
76561198210748881,765,5,5,0,0,0,0,5,0,4,5,13,571.892425,8
76561198033211184,1840,18,15,2,0,0,0,17,1,4,18,9,135.34797647058824,6
76561198306564163,1311,13,9,2,1,1,0,10,3,5,13,11,156.71490833333334,5
76561197991879447,1383,16,11,1,0,1,2,13,3,5,16,12,155.02391333333335,7
76561198074340508,920,5,2,1,0,0,0,5,0,5,5,17,371.39750000000004,9
76561198394518541,1124,6,4,2,0,0,0,5,1,5,6,15,348.6413999999999,9
76561197960827249,1842,16,15,0,0,0,1,13,3,5,16,11,158.9539,11
76561198302331165,982,8,8,0,0,0,0,3,5,5,8,12,211.07520000000008,4
76561198305342763,677,7,4,2,0,1,0,6,1,5,7,5,380.1670166666667,2
76561198096865460,1235,10,10,0,0,0,0,9,1,4,10,8,252.98631111111112,7
76561198411766851,1050,9,6,2,1,0,0,9,0,4,9,6,264.98220000000003,4
76561198310519253,489,7,6,0,0,1,0,4,3,5,7,3,162.43166666666673,3
76561198299487774,876,8,3,5,0,0,0,5,3,5,8,5,302.69832857142853,3
76561197991265977,811,5,3,0,0,1,0,3,2,5,5,9,348.059,6
76561198041885454,831,8,8,0,0,0,0,7,1,5,8,7,292.81314285714285,4
76561198010422933,588,5,2,0,1,1,1,4,1,5,5,9,493.905125,4
76561197995954725,228,1,1,0,0,0,0,1,0,5,1,8,0.0,4
76561197990680618,743,8,7,0,0,0,1,3,5,4,8,8,310.2841142857143,3
76561198264174024,1023,8,5,2,1,0,0,5,3,5,8,7,101.79778571428572,5
76561198246582480,484,4,3,1,0,0,0,4,0,5,4,9,565.7283666666667,2
76561198361780975,565,5,3,2,0,0,0,5,0,4,5,9,204.57567500000005,4
76561198196155171,477,3,1,0,1,0,0,3,0,5,3,9,274.28375,6
76561198214077216,365,2,2,0,0,0,0,2,0,5,2,9,95.9661000000001,4
76561198068536694,993,8,5,3,0,0,0,8,0,5,8,6,196.92380000000009,7
76561198037209671,835,9,5,3,1,0,0,8,1,5,9,5,211.68321250000002,2
76561198156291661,738,8,7,1,0,0,0,7,1,4,8,2,133.8339,2
76561198088704127,1305,12,5,7,0,0,0,9,3,3,12,3,152.04180909090908,3
76561198200250251,449,6,5,0,0,0,1,4,2,4,6,6,279.10692,1
76561198273574814,356,1,1,0,0,0,0,1,0,5,1,5,0.0,4
76561198280670646,773,6,2,4,0,0,0,6,0,5,6,5,175.267,4
76561198097612731,595,5,1,3,1,0,0,5,0,4,5,6,212.17352500000004,2
76561197979010139,363,2,1,0,0,1,0,2,0,3,2,6,829.5274999999999,4
76561198181561430,452,6,5,0,1,0,0,5,1,5,6,5,130.14164,1
76561198300358357,435,6,4,0,0,2,0,4,2,3,6,4,196.90404,1
76561198344201881,965,9,2,3,4,0,0,8,1,5,9,5,115.70541250000001,3
76561198085915993,363,4,3,0,0,1,0,4,0,4,4,4,130.3646666666667,1
76561198199319723,720,6,6,0,0,0,0,5,1,5,6,4,166.27427999999998,5
76561198010687315,226,2,1,1,0,0,0,1,1,4,2,3,262.2406000000001,1
76561197963540256,268,3,2,0,0,0,0,3,0,4,3,11,456.9665,4
76561198086832903,915,9,2,6,1,0,0,7,2,5,9,10,311.6854,5
76561198074904016,901,7,7,0,0,0,0,6,1,5,7,10,166.673,8
76561198120672186,1525,14,14,0,0,0,0,12,2,4,14,10,151.05825384615383,7
76561197999633886,1487,13,12,1,0,0,0,11,2,3,13,9,199.12508333333332,7
76561197992682385,874,7,6,0,1,0,0,6,1,5,7,10,371.53316666666683,4
76561197993403306,1082,13,7,6,0,0,0,13,0,4,13,9,175.73658333333333,6
76561198094604241,1131,9,8,1,0,0,0,9,0,5,9,10,225.9398750000001,6
76561197979285182,832,8,7,0,0,1,0,6,2,3,8,9,275.7192857142857,7
76561198081894984,1327,13,8,3,2,0,0,12,1,5,13,8,185.40458333333333,2
76561198156291661,1426,12,6,5,0,1,0,10,2,5,12,10,212.98896363636368,8
76561198068536694,1463,13,2,10,1,0,0,9,4,4,13,8,211.67109166666668,6
76561198200250251,1108,13,11,1,0,0,1,8,5,3,13,8,188.17410833333338,2
76561198147100360,787,7,7,0,0,0,0,7,0,5,7,10,67.5168,6
76561198037209671,639,5,3,0,0,2,0,5,0,5,5,12,298.53625,6
76561198068146264,1653,19,9,8,2,0,0,18,1,5,19,8,126.93391111111113,4
76561198057778007,1218,9,8,1,0,0,0,9,0,5,9,11,308.33785,5
76561198282459364,718,7,3,1,1,1,0,7,0,5,7,12,319.76478333333336,8
76561198073215834,796,7,7,0,0,0,0,2,5,4,7,8,323.42656666666664,8
76561198258265035,842,6,3,2,1,0,0,5,1,3,6,11,486.63374000000005,10
76561198349920983,890,9,0,6,0,0,0,7,2,5,9,11,186.42862499999998,3
76561198186821377,360,2,1,0,0,1,0,1,1,5,2,8,420.5810999999999,7
76561198258834656,1023,10,6,2,1,0,1,9,1,4,10,12,188.74815555555554,7
76561198314566084,674,7,4,1,1,0,1,4,3,5,7,8,175.65616666666665,5
76561198301111007,822,9,7,2,0,0,0,6,3,4,9,9,205.91037500000002,4
76561198063315249,1183,10,3,7,0,0,0,10,0,5,10,8,143.77093333333335,6
76561198342472190,1253,16,7,6,2,0,0,7,9,4,16,4,124.13513333333334,3
76561198381557887,707,6,6,0,0,0,0,6,0,5,6,7,176.3034000000001,4
76561198346685067,1104,10,6,2,1,1,0,8,2,5,10,9,183.08000000000007,5
76561198197158845,635,5,1,2,0,2,0,4,1,5,5,8,270.22049999999996,1
76561198193887373,1006,9,0,0,1,8,0,7,2,5,9,11,178.05222499999996,5
76561198305588168,1020,10,5,3,0,2,0,5,5,5,10,8,198.15444444444452,5
76561198373508973,979,7,4,3,0,0,0,6,1,4,7,10,240.44491666666667,9
76561198358238170,709,6,6,0,0,0,0,6,0,5,6,9,232.28482,7
76561197982458078,718,9,8,1,0,0,0,9,0,5,9,7,199.733975,3
76561198017600974,1471,13,6,6,1,0,0,12,1,5,13,10,176.329375,7
76561198149058012,986,9,5,2,1,1,0,7,2,5,9,8,233.59265,3
76561198329893911,275,4,1,2,0,1,0,3,1,5,4,4,395.68399999999997,2
76561198072764142,964,6,5,0,0,0,0,5,1,5,6,11,330.43794,6
76561198160803605,1309,13,13,0,0,0,0,11,2,4,13,8,149.662725,4
76561198216722571,936,7,5,2,0,0,0,7,0,4,7,9,183.23243333333343,6
76561198168898621,1186,11,10,1,0,0,0,9,2,5,11,7,138.50572000000003,4
76561198214259301,739,7,5,1,0,1,0,5,2,5,7,8,163.27673333333334,3
76561198019009402,883,9,8,0,1,0,0,7,2,5,9,6,106.131175,5
76561198107191598,795,10,3,7,0,0,0,9,1,5,10,5,124.8671222222222,1
76561198200173077,591,4,4,0,0,0,0,3,1,5,4,10,313.57259999999997,4
76561198129701762,880,7,3,3,1,0,0,6,1,4,7,7,158.5261,8
76561198013283167,1056,8,7,0,0,1,0,7,1,4,8,9,150.87697142857147,7
76561197969004816,692,7,6,0,0,1,0,5,2,3,7,9,214.17931666666667,4
76561198096881621,749,9,9,0,0,0,0,8,1,4,9,9,76.61161249999999,3
76561198211474859,740,7,4,0,3,0,0,6,1,5,7,10,202.56006666666667,8
76561198069076774,1685,15,11,2,2,0,0,13,2,5,15,9,136.2658928571429,9
76561198309694536,814,9,5,0,4,0,0,5,4,4,9,6,240.66091250000002,5
76561198342472190,563,2,2,0,0,0,0,2,0,5,2,9,719.0520000000002,7
76561198028239876,932,9,3,6,0,0,0,8,1,4,9,6,205.31695,3
76561198244996314,1285,11,6,1,0,4,0,9,2,5,11,9,190.71604,7
76561198283915147,520,2,2,0,0,0,0,1,1,5,2,10,1114.9423000000002,7
76561198253113453,1106,15,12,1,1,0,0,14,1,3,15,7,132.4283785714286,4
76561198161016824,849,8,2,2,0,4,0,8,0,5,8,8,244.76962857142863,5
76561198263031971,599,5,4,0,0,1,0,1,4,4,5,9,345.8685,6
76561198329395552,910,8,4,2,0,2,0,8,0,5,8,4,158.4001,3
76561198076148162,664,6,5,1,0,0,0,4,2,4,6,6,204.42032,2
76561198341941978,808,10,10,0,0,0,0,9,1,3,10,2,126.76642222222225,1
76561197961424834,960,11,0,10,0,1,0,11,0,4,11,1,115.20558999999999,0
76561198344627068,589,5,2,2,1,0,0,4,1,3,5,3,272.410325,5
76561198009637857,674,4,0,3,0,1,0,4,0,5,4,7,271.9728333333333,5
76561198338143276,167,2,2,0,0,0,0,2,0,5,2,8,446.99559999999997,1
76561198027230668,378,4,4,0,0,0,0,4,0,4,4,9,162.23986666666667,3
76561198106154054,405,4,1,3,0,0,0,3,1,5,4,8,345.65943333333325,1
76561198353797694,356,2,0,1,0,1,0,2,0,5,2,8,918.8068,4
76561198237026880,970,10,1,8,1,0,0,7,3,5,10,2,76.57016666666668,4
76561198085182023,894,7,7,0,0,0,0,6,1,4,7,14,137.28666666666666,5
76561198219669320,760,5,4,1,0,0,0,5,0,5,5,10,319.7564,7
76561198314106073,1066,9,7,0,2,0,0,9,0,5,9,12,213.134375,6
76561198198984037,950,8,8,0,0,0,0,8,0,5,8,10,222.76120000000006,9
76561198114050756,944,9,8,1,0,0,0,8,1,5,9,9,186.4261875,6
76561198079035022,1781,15,11,4,0,0,0,14,1,4,15,8,129.94664285714285,5
76561198098776450,927,12,8,2,2,0,0,4,8,3,12,8,162.08489090909092,4
76561198125786164,554,5,5,0,0,0,0,5,0,5,5,10,415.08705000000015,6
76561198121952576,474,8,7,0,0,0,0,6,2,4,8,5,211.09381428571427,2
76561198063393482,967,9,2,0,0,7,0,6,3,5,9,5,217.07128749999998,7
76561198202993819,953,10,4,6,0,0,0,10,0,5,10,3,193.34464444444447,3
76561197983855605,695,6,4,0,0,2,0,5,1,4,6,6,433.42683999999997,6
76561197977337351,346,4,4,0,0,0,0,2,2,5,4,4,426.5843333333334,5
76561198161914308,274,2,1,1,0,0,0,2,0,3,2,5,1630.429,3
76561198276705907,873,10,6,0,1,3,0,9,1,4,10,7,238.31657777777778,4
76561198161929122,337,3,3,0,0,0,0,2,1,4,3,6,421.15615,3
76561198140766688,501,4,1,2,1,0,0,2,2,5,4,6,356.37566666666663,3
76561198186706253,363,2,1,0,1,0,0,2,0,5,2,7,1848.6179000000002,4
76561198337923460,302,3,1,1,0,1,0,2,1,5,3,4,940.5143499999999,1
76561198205091101,511,5,1,4,0,0,0,4,1,5,5,9,201.44302500000003,1
76561198103031594,775,5,4,0,1,0,0,5,0,5,5,8,163.16262500000002,5
76561198179109297,817,7,2,2,0,3,0,7,0,5,7,8,150.35565,4
76561198153902838,791,7,2,3,0,2,0,7,0,5,7,8,232.94886666666665,2
76561198075516625,604,6,4,2,0,0,0,6,0,5,6,8,204.19974,4
76561197960400760,462,2,1,1,0,0,0,2,0,5,2,8,246.63799999999992,5
76561198080432896,1032,11,3,7,1,0,0,9,2,5,11,4,158.96032000000002,1
76561198116690447,680,6,0,3,3,0,0,6,0,5,6,8,191.08487999999997,4
76561197960973277,1381,13,9,2,2,0,0,12,1,4,13,6,90.20135833333335,3
76561198268411464,715,9,4,3,2,0,0,7,2,4,9,4,195.7623375,1
76561198271543248,943,9,9,0,0,0,0,7,2,4,9,3,114.9759125,6
76561198202204342,1006,9,7,0,0,2,0,7,2,5,9,8,115.2298375,3
76561197960973277,813,8,2,5,0,0,1,7,1,5,8,6,137.22368571428572,4
76561198211983321,463,7,6,0,0,1,0,7,0,2,7,4,162.3291,2
76561198262696393,659,5,4,0,0,1,0,5,0,5,5,5,121.84450000000004,6
76561198049391918,560,5,4,1,0,0,0,3,2,5,5,8,223.16925000000003,6
76561198051425587,400,4,4,0,0,0,0,3,1,3,4,8,303.31010000000003,4
76561198084443857,674,6,6,0,0,0,0,6,0,5,6,7,208.59144,5
76561198031659297,523,4,4,0,0,0,0,2,2,4,4,8,302.8310000000001,3
76561198054370052,762,7,3,2,2,0,0,6,1,3,7,7,118.49221666666666,3
76561198254945411,710,5,5,0,0,0,0,5,0,5,5,9,121.45875000000001,4
76561198355705239,785,9,2,1,0,6,0,4,5,4,9,8,199.04141249999998,6
76561198013586664,917,7,7,0,0,0,0,5,2,5,7,8,258.26276666666666,3
76561198273274502,431,5,4,1,0,0,0,1,4,5,5,8,208.6558,3
76561198045646320,237,1,0,0,0,0,0,1,0,5,1,9,0.0,4
76561198267370957,1222,14,8,3,2,1,0,11,3,5,14,4,135.86834615384615,1
76561198215017448,860,8,6,0,1,0,0,4,4,5,8,6,183.88628571428575,4
76561198288888009,652,5,5,0,0,0,0,5,0,4,5,6,394.856,4
76561198380363897,706,6,4,2,0,0,0,5,1,3,6,6,349.24462000000005,5
76561198203664789,794,9,8,0,0,1,0,6,3,3,9,5,215.47296249999997,1
76561198374674794,1843,16,10,3,2,0,0,9,7,5,16,12,148.84749333333335,11
76561198275453655,1173,10,4,3,1,2,0,7,3,4,10,14,228.7811,5
76561198411101714,975,7,2,3,0,2,0,6,1,4,7,12,237.44725000000003,7
76561198256086583,1190,11,7,2,2,0,0,8,3,5,11,11,225.22464000000005,3
76561198409046381,636,8,4,0,0,4,0,6,2,5,8,10,319.8518714285715,4
76561198315839914,3096,29,8,12,3,5,1,25,4,5,29,8,88.07580714285713,11
76561198360655109,424,3,1,1,1,0,0,2,1,5,3,13,1207.2135,5
76561198380061091,528,2,2,0,0,0,0,1,1,5,2,13,1508.3210000000004,8
76561198356778379,2040,23,7,2,2,12,0,17,6,3,23,9,110.25383636363637,7
76561198380519872,540,2,1,1,0,0,0,1,1,3,2,9,857.7544999999999,7
76561198304820381,927,7,7,0,0,0,0,5,2,5,7,10,271.54955,7
76561198000743634,1566,13,8,4,0,1,0,12,1,5,13,10,164.9187083333333,10
76561198093394730,919,7,1,1,0,5,0,7,0,4,7,12,237.18331666666663,6
76561198274569450,555,4,2,2,0,0,0,2,2,3,4,10,611.7690999999999,5
76561198048782331,889,10,7,1,1,1,0,9,1,5,10,10,170.8781666666667,4
76561198254841440,537,4,4,0,0,0,0,4,0,5,4,9,625.0220333333333,3
76561198287639229,1778,19,14,4,1,0,0,17,2,4,19,9,109.46303888888889,3
76561198264606703,1084,12,5,7,0,0,0,10,2,3,12,6,147.41889090909092,1
76561198249681790,872,7,6,0,0,0,1,7,0,5,7,9,290.82436666666666,4
76561198249081172,1035,9,9,0,0,0,0,9,0,5,9,7,211.5152875,4
76561198088140483,694,4,4,0,0,0,0,4,0,4,4,7,697.2925666666666,6
76561198247675172,683,7,3,4,0,0,0,5,2,4,7,5,283.4608166666667,4
76561198262727977,659,5,4,0,1,0,0,3,2,5,5,7,334.39874999999995,6
76561198076248133,518,6,4,1,0,1,0,5,1,3,6,6,338.46503999999993,3
76561198324877049,768,7,3,4,0,0,0,5,2,5,7,5,314.4673833333333,2
76561198387770063,495,4,1,2,0,0,1,3,1,5,4,6,573.2977,3
76561198337288568,491,3,3,0,0,0,0,2,1,5,3,7,229.87655,4
76561198305235533,839,7,4,3,0,0,0,6,1,5,7,5,250.04223333333334,4
76561198338342304,895,9,6,2,0,0,1,5,4,4,9,7,181.628125,3
76561198216514259,702,8,6,2,0,0,0,4,4,3,8,5,180.36837142857144,2
76561198258189979,847,8,6,2,0,0,0,6,2,5,8,6,301.8214,3
76561198007428623,708,5,2,3,0,0,0,5,0,4,5,6,381.10415,9
76561198257676544,748,9,4,5,0,0,0,9,0,4,9,7,231.7627,1
76561198264053133,1463,16,15,1,0,0,0,15,1,3,16,6,163.81866666666664,3
76561197977645221,578,2,2,0,0,0,0,1,1,5,2,8,1407.7800000000002,6
76561198269068585,575,5,2,2,1,0,0,5,0,5,5,9,601.287625,4
76561197997050283,1597,14,6,8,0,0,0,12,2,5,14,7,144.27,9
76561198017538709,535,6,5,0,0,1,0,5,1,5,6,9,356.8380000000001,5
76561198295868894,811,7,6,0,0,1,0,6,1,5,7,8,277.6445000000001,6
76561198283097859,318,1,0,0,1,0,0,0,1,5,1,7,0.0,5
76561198111851256,1125,13,12,0,0,1,0,9,4,5,13,12,207.4349583333333,8
76561198084662343,464,2,1,0,0,1,0,2,0,5,2,9,424.96729999999997,9
76561198138937855,1482,18,15,0,1,2,0,12,6,4,18,9,142.65491176470587,7
76561197995808190,1758,11,7,1,0,2,1,11,0,5,11,13,239.9717900000001,10
76561198048057486,1330,13,7,4,1,1,0,9,4,5,13,8,207.348925,8
76561198085951569,911,7,4,2,0,1,0,6,1,5,7,11,398.81193333333334,7
76561198076815693,898,10,7,0,0,3,0,5,5,5,10,13,192.03867777777776,4
76561198081457328,880,7,6,1,0,0,0,4,3,5,7,11,310.9935,7
76561197969862041,1074,10,3,4,1,1,1,9,1,4,10,11,296.8372888888889,5
76561197995942012,1597,17,9,6,0,2,0,13,4,3,17,11,166.01750625000003,5
76561198041454856,1274,12,11,0,1,0,0,7,5,5,12,8,160.62531818181816,5
76561198098776450,1060,11,4,5,0,2,0,9,2,5,11,10,210.77580000000003,4
76561198053635563,1397,13,11,0,0,2,0,13,0,4,13,12,195.7234083333333,8
76561198079035022,1261,13,11,1,0,1,0,9,4,4,13,6,197.47374999999997,3
76561198076082211,738,6,6,0,0,0,0,6,0,5,6,11,450.70744,8
76561198143656685,723,6,1,5,0,0,0,6,0,5,6,11,395.20274,3
76561198087652540,984,8,6,1,0,1,0,8,0,5,8,12,318.3706571428571,7
76561198254565037,1058,10,7,0,1,2,0,8,2,3,10,10,233.01804444444446,4
76561198020643369,1308,14,8,3,3,0,0,6,8,3,14,10,159.02893846153844,5
76561198215467459,813,8,6,1,1,0,0,4,4,5,8,11,187.84057142857142,4
76561198038958852,1750,17,8,4,3,2,0,17,0,5,17,12,161.68240624999999,4
76561198014341663,993,10,6,4,0,0,0,10,0,5,10,12,236.58973333333336,7
76561198110191166,1192,12,11,0,0,1,0,10,2,4,12,10,236.75983636363642,6
76561198012517491,758,4,2,0,0,2,0,4,0,5,4,13,156.40233333333344,11
76561198078795845,619,4,2,0,1,1,0,4,0,5,4,13,654.4366666666667,10
76561198319082120,1101,14,11,0,0,3,0,10,4,5,14,9,200.22709230769232,4
76561198143178976,1526,13,6,1,1,4,1,12,1,4,13,12,216.94129999999998,8
76561198171616777,1278,12,2,9,1,0,0,12,0,3,12,10,201.97543636363636,5
76561198166260620,1537,15,8,5,0,2,0,15,0,3,15,8,171.14805,8
76561198051942833,1005,7,4,1,0,2,0,7,0,5,7,9,370.28305,9
76561198118718180,798,7,7,0,0,0,0,5,2,5,7,8,163.19841666666667,4
76561198065350259,866,10,10,0,0,0,0,4,6,4,10,6,105.72538888888887,4
76561198155115183,1752,16,6,10,0,0,0,11,5,3,16,5,95.86238,7
76561198078958929,313,3,1,2,0,0,0,3,0,5,3,10,614.7601500000001,1
76561198082509147,530,4,4,0,0,0,0,4,0,5,4,10,126.43099999999997,5
76561197980475122,1038,8,8,0,0,0,0,8,0,5,8,8,183.22315714285713,7
76561198070320883,680,7,5,1,0,0,1,5,2,4,7,8,240.94276666666667,4
76561198066896068,835,9,7,0,0,2,0,8,1,5,9,10,182.16825,6
76561197995434036,965,8,2,4,2,0,0,8,0,4,8,8,168.5908142857143,4
76561198003335554,553,7,4,0,2,0,1,5,2,5,7,6,235.10298333333333,3
76561198063220222,800,6,6,0,0,0,0,5,1,5,6,8,252.717,5
76561198054201588,616,3,1,0,0,1,1,3,0,5,3,9,371.06809999999996,11
76561198000241236,929,11,3,7,0,1,0,9,2,4,11,8,94.79155,1
76561198215579697,1442,11,8,0,2,0,1,11,0,3,11,9,136.83189,11
76561198101175841,1260,14,13,0,1,0,0,7,7,3,14,4,100.80751538461537,3
76561198015865496,1120,9,8,1,0,0,0,8,1,5,9,9,175.41547500000001,6
76561197993917651,388,5,0,1,0,4,0,3,2,5,5,10,215.40552499999998,3
76561197960488729,1168,12,7,0,0,5,0,8,4,4,12,7,124.63693636363637,5
76561198007690357,840,6,5,1,0,0,0,6,0,5,6,9,136.71300000000002,6
76561198011073592,708,6,4,0,0,2,0,6,0,5,6,10,149.75871999999998,4
76561198202957619,555,2,2,0,0,0,0,2,0,5,2,14,6.094000000000051,8
76561198101906855,1831,16,11,4,0,1,0,13,3,5,16,11,143.75648666666663,9
76561198200143282,1166,10,5,3,2,0,0,10,0,5,10,11,185.30615555555553,9
76561198374792726,838,4,4,0,0,0,0,3,1,5,4,11,522.3435666666667,9
76561197960372755,1166,18,0,4,0,0,1,14,4,5,18,11,122.54587647058827,4
76561198019231558,1393,15,13,0,0,2,0,14,1,5,15,11,156.36649285714287,1
76561197984239889,1383,13,13,0,0,0,0,9,4,5,13,12,171.89044166666667,8
76561198111636357,1442,14,12,1,1,0,0,13,1,4,14,7,159.22824615384616,4
76561197961394195,1388,11,11,0,0,0,0,10,1,4,11,8,201.35892,9
76561198124079905,805,5,0,1,3,0,1,4,1,5,5,12,488.091525,5
76561198388180430,1256,8,8,0,0,0,0,8,0,4,8,10,319.35984285714284,8
76561198391236513,1155,15,13,1,0,0,1,9,6,5,15,9,190.18680714285713,7
76561198286146056,937,7,7,0,0,0,0,6,1,5,7,9,345.41781666666674,10
76561198388987416,1153,10,8,0,0,2,0,10,0,5,10,9,260.4822444444446,7
76561198198614667,1187,10,8,0,1,1,0,9,1,5,10,11,252.31844444444445,10
76561198320069820,940,9,8,0,0,0,0,9,0,5,9,12,334.26061250000004,5
76561198193567478,1605,14,8,4,0,2,0,13,1,4,14,11,184.04809230769231,7
76561198279247348,928,9,7,1,0,1,0,7,2,4,9,8,332.0064875,4
76561198147963919,1305,12,8,1,1,2,0,10,2,3,12,9,236.71175454545454,7
76561198093758050,679,4,3,0,0,1,0,2,2,5,4,10,536.6463333333336,8
76561198290168739,917,10,5,2,1,2,0,10,0,5,10,14,192.47077777777778,10
76561198361059965,690,8,5,0,0,2,1,8,0,4,8,12,329.00617142857146,5
76561198342625382,843,11,9,0,0,1,1,9,2,4,11,10,206.6105700000001,6
76561198051480016,1292,16,14,1,0,1,0,14,2,5,16,12,127.39393999999999,6
76561198098776450,1194,14,10,2,1,1,0,9,5,5,14,13,129.82024615384617,3
76561198038766716,1269,12,10,0,0,0,1,10,2,5,12,21,194.7273454545455,6
76561198159193694,100,1,0,1,0,0,0,1,0,5,1,2,0.0,0
76561198216824293,1554,17,3,12,2,0,0,14,3,4,17,8,129.9443375,6
76561198320600765,2002,18,17,0,0,1,0,16,2,4,18,12,137.38722352941176,9
76561198354171686,1380,14,8,2,0,4,0,12,2,3,14,17,174.72867692307693,4
76561198362081060,333,3,3,0,0,0,0,3,0,5,3,7,768.50185,3
76561198058004261,499,3,3,0,0,0,0,2,1,5,3,7,721.1307,4
76561198329784181,752,7,6,1,0,0,0,7,0,4,7,6,148.3386833333333,4
76561198243049872,584,4,1,0,2,1,0,4,0,3,4,7,497.62253333333337,2
76561198119918521,542,6,5,0,0,0,0,6,0,3,6,5,273.29232,3
76561198290816198,514,2,2,0,0,0,0,2,0,5,2,7,1039.7251999999999,4
76561198062714349,328,2,1,0,0,1,0,2,0,5,2,4,1349.3321999999998,3
76561198148990744,826,7,1,3,3,0,0,5,2,4,7,3,216.85029999999998,4
76561198047371059,1052,14,14,0,0,0,0,12,2,4,14,4,119.96222307692308,4
76561198085886319,588,7,7,0,0,0,0,7,0,5,7,5,240.56451666666666,2
76561198017410249,2096,19,6,13,0,0,0,19,0,5,19,14,109.90726666666666,9
76561198062995717,1450,14,6,1,3,4,0,10,4,5,14,16,163.40585384615386,10
76561198070410306,1957,15,5,5,0,5,0,14,1,4,15,13,147.14474285714283,11
76561198065177583,1040,10,4,0,1,5,0,8,2,5,10,16,221.22845555555557,7
76561198282845038,1504,16,3,9,3,1,0,15,1,5,16,11,123.81607333333334,4
76561198302090970,1721,12,6,4,1,0,0,10,2,5,12,17,172.08026363636367,8
76561198069744787,2098,18,17,0,0,1,0,13,5,4,18,13,120.23454117647057,10
76561198156034345,1649,18,5,7,1,4,0,15,3,3,18,15,126.29445882352941,4
76561198215078537,1388,13,7,2,4,0,0,13,0,5,13,15,140.33600833333333,8
76561198116856300,915,9,7,0,0,2,0,7,2,5,9,14,204.88416250000003,4
76561198122928593,959,10,5,5,0,0,0,9,1,5,10,3,161.7602222222222,1
76561198240757436,751,6,3,2,0,1,0,6,0,4,6,6,125.50883999999999,4
76561198126835308,672,7,7,0,0,0,0,7,0,5,7,5,168.1954166666667,3
76561198283254140,677,6,3,2,1,0,0,4,2,5,6,4,268.72084,3
76561198141780485,305,5,2,3,0,0,0,5,0,5,5,2,202.808,0
76561198120298927,573,4,1,1,0,2,0,4,0,5,4,7,275.67233333333337,3
76561198011639666,469,6,0,2,4,0,0,5,1,5,6,6,267.1018,2
76561198318011880,395,4,3,0,0,1,0,4,0,4,4,7,489.0104666666666,1
76561198196126689,720,5,5,0,0,0,0,5,0,5,5,6,345.433925,4
76561198083957522,129,0,0,0,0,0,0,0,0,0,0,7,0.0,2
76561198131365497,379,5,3,0,1,0,1,5,0,5,5,5,317.11445,3
76561198173867690,904,9,3,4,2,0,0,9,0,5,9,5,190.4280750000001,4
76561198143050815,628,5,3,0,0,2,0,4,1,4,5,5,349.77060000000006,4
76561198203700880,1211,14,1,13,0,0,0,12,2,5,14,5,101.8294846153846,2
76561198288075846,651,3,3,0,0,0,0,1,2,5,3,5,23.42750000000001,6
76561198019358397,361,2,2,0,0,0,0,0,2,5,2,8,14.097000000000207,3
76561198173003274,585,5,0,0,0,4,0,5,0,4,5,8,362.87525,4
76561198068110175,1032,11,7,3,0,1,0,8,3,3,11,7,147.84139,1
76561198153346475,529,4,4,0,0,0,0,3,1,5,4,6,24.68299999999984,5
76561198082225391,404,3,2,1,0,0,0,1,2,5,3,7,644.3093,4
76561198379924077,1859,18,15,0,0,3,0,14,4,5,18,9,84.99507647058824,7
76561198097402553,1357,12,8,0,2,2,0,11,1,4,12,10,133.38273636363635,8
76561198079203504,707,9,7,0,0,2,0,7,2,4,9,6,169.99165000000005,9
76561198111270866,1116,7,3,2,1,1,0,7,0,5,7,11,192.50136666666666,9
76561198348077746,859,10,3,3,1,0,0,7,3,4,10,9,146.56986666666666,4
76561198044028830,1429,10,9,0,0,1,0,8,2,5,10,12,65.93895555555555,9
76561197991960387,1450,10,9,0,0,0,1,10,0,5,10,11,159.86185555555554,10
76561198107447282,699,11,2,5,1,3,0,5,6,3,11,9,142.98149,4
76561198031959193,768,6,3,0,0,3,0,4,2,5,6,12,215.85586000000004,6
76561198248665212,800,8,1,0,1,0,1,5,3,4,8,12,183.76585714285716,6
76561198042535091,2254,25,9,14,1,0,1,18,7,4,25,9,91.91465000000001,5
76561198258210497,1944,15,5,8,2,0,0,14,1,5,15,13,168.5652857142857,9
76561198155129258,1970,20,10,6,4,0,0,17,3,4,20,16,139.4121263157895,5
76561198255833105,821,7,2,0,2,2,1,7,0,4,7,13,392.6728666666666,9
76561198106061001,871,8,8,0,0,0,0,6,2,5,8,12,134.29400000000004,6
76561198302090970,1411,14,3,9,0,1,0,12,2,5,14,14,183.84516153846153,5
76561198101606059,1654,16,15,0,0,1,0,13,3,5,16,15,128.06494666666669,8
76561198069744787,1107,11,11,0,0,0,0,11,0,5,11,16,224.06829,7
76561198215078537,1911,15,15,0,0,0,0,13,2,5,15,14,146.5282857142857,11
76561198202057777,649,6,3,2,1,0,0,6,0,5,6,15,437.48902,3
76561198381297092,512,5,5,0,0,0,0,5,0,4,5,8,267.282,3
76561198283917685,327,3,3,0,0,0,0,3,0,5,3,8,108.6880000000001,2
76561198243304928,639,12,11,0,1,0,0,10,2,4,12,6,136.61687272727272,0
76561197961424834,628,6,2,4,0,0,0,6,0,4,6,7,283.63582,2
76561198157168721,848,8,5,1,2,0,0,8,0,3,8,8,201.36024285714296,4
76561198316955620,1957,18,12,6,0,0,0,14,4,5,18,5,89.46551176470588,6
76561198343636279,169,1,0,1,0,0,0,1,0,5,1,1,0.0,1
76561198085425746,777,8,4,3,1,0,0,7,1,5,8,13,135.46657142857143,2
76561198183169293,606,5,2,3,0,0,0,4,1,5,5,9,238.80125000000004,3
76561198344255592,519,6,2,2,0,2,0,5,1,5,6,7,128.244,0
76561198198436259,380,6,5,1,0,0,0,2,4,5,6,6,284.03459999999995,1
76561198364483897,887,6,3,0,1,2,0,6,0,4,6,13,275.47722,8
76561198174087538,200,2,0,2,0,0,0,2,0,5,2,2,116.89189999999996,0
76561198349507119,701,4,3,0,1,0,0,2,2,5,4,14,210.26983333333337,5
76561198135673673,936,7,5,0,2,0,0,7,0,4,7,8,178.56226666666666,7
76561198071680102,1100,12,11,0,0,1,0,12,0,5,12,3,103.43820909090914,6
76561198315826101,1117,12,11,0,0,1,0,11,1,4,12,5,99.67343636363636,2
76561198111851256,634,9,4,4,0,1,0,7,2,5,9,6,103.6516125,4
76561198306339851,613,9,7,0,0,2,0,9,0,5,9,6,109.2383875,3
76561198253737984,204,1,1,0,0,0,0,0,1,5,1,5,0.0,4
76561198018374864,1286,12,4,8,0,0,0,11,1,5,12,9,181.5673,4
76561198117379779,855,8,5,1,0,1,1,8,0,4,8,9,291.0001285714286,4
76561197960694816,920,9,5,4,0,0,0,8,1,4,9,12,205.58502499999997,3
76561198210393340,367,3,3,0,0,0,0,1,2,5,3,5,64.18860000000001,2
76561197980220179,1126,11,8,2,1,0,0,8,3,5,11,7,155.83130999999997,8
76561198300509712,480,5,3,1,1,0,0,5,0,5,5,11,493.597675,1
76561198002367080,866,8,7,1,0,0,0,7,1,3,8,9,279.42562857142855,3
76561198284162673,1118,12,11,0,0,0,0,5,7,5,12,5,180.75743636363634,5
76561198062522041,1061,8,5,3,0,0,0,7,1,5,8,10,169.62462857142856,4
76561197967934235,764,9,7,1,1,0,0,5,4,5,9,8,227.31328749999997,5
76561198374379750,994,7,2,0,0,5,0,6,1,5,7,17,167.79366666666667,9
76561198282952822,1027,11,2,7,2,0,0,5,6,5,11,8,89.48970000000001,6
76561198255827573,1117,11,8,0,0,2,1,8,3,3,11,9,183.97655000000003,8
76561198236264966,775,6,4,1,0,1,0,5,1,4,6,11,363.93528000000003,4
76561198372909040,523,5,2,0,3,0,0,4,1,5,5,7,320.171275,6
76561198069945854,1011,11,8,0,1,2,0,8,3,5,11,7,211.37196,3
76561198023280165,1154,12,6,0,0,6,0,10,2,5,12,10,184.68910909090908,9
76561198143097013,893,7,4,0,0,3,0,4,3,4,7,9,349.2565833333333,8
76561198220133827,851,10,10,0,0,0,0,7,3,5,10,9,192.03750000000002,3
76561198156068286,951,12,3,6,2,0,1,9,3,4,12,5,184.77733636363644,5
76561198299531276,763,7,4,2,1,0,0,3,4,5,7,7,187.30443333333332,5
76561198065106005,1162,12,3,0,0,9,0,11,1,4,12,7,98.1997727272727,6
76561198396990507,550,4,0,2,1,1,0,2,2,5,4,8,213.26013333333336,6
76561198078457263,548,5,2,3,0,0,0,3,2,5,5,9,144.52177500000002,6
76561198319870848,757,4,1,0,0,3,0,4,0,4,4,9,283.2458666666667,10
76561198282958474,938,7,1,0,0,6,0,5,2,5,7,7,165.44299999999998,5
76561198259541461,756,8,5,3,0,0,0,6,2,4,8,4,105.62624285714286,2
76561198276846840,1685,17,17,0,0,0,0,11,6,4,17,4,67.62759375,5
76561198074001167,516,4,1,0,0,3,0,4,0,5,4,9,228.34473333333332,5
76561198168119340,536,4,2,0,1,1,0,4,0,5,4,8,176.30870000000004,6
76561198308216709,768,5,5,0,0,0,0,5,0,5,5,9,442.979425,4
76561198058924457,603,5,4,1,0,0,0,5,0,4,5,9,426.53177500000004,4
76561198316538017,843,9,4,5,0,0,0,7,2,4,9,6,239.3087375,2
76561198078968504,751,8,8,0,0,0,0,7,1,5,8,7,83.74442857142857,5
76561198323350178,615,6,5,0,1,0,0,6,0,5,6,8,89.1944,4
76561197961278712,1404,15,1,14,0,0,0,15,0,5,15,7,137.9824,2
76561198072321722,811,3,3,0,0,0,0,3,0,5,3,8,75.16750000000002,9
76561198147503174,667,5,2,1,1,0,1,4,1,5,5,5,236.23024999999996,6
76561198027725092,440,7,6,0,0,1,0,7,0,3,7,5,282.6095166666667,1
76561198074011585,848,9,9,0,0,0,0,8,1,3,9,8,233.2258625,3
76561198156089445,737,6,4,0,0,1,0,6,0,4,6,10,404.86826,6
76561198077898408,1041,11,7,4,0,0,0,10,1,4,11,6,199.59305,4
76561198265845129,1268,12,11,0,0,1,0,11,1,4,12,7,207.20255454545452,5
76561198322461747,337,3,2,0,0,1,0,3,0,5,3,9,813.7311000000004,1
76561198132741256,697,6,6,0,0,0,0,5,1,5,6,10,335.09412000000003,5
76561198041212078,691,5,2,1,2,0,0,5,0,5,5,9,573.448275,6
76561198031287013,827,8,1,7,0,0,0,6,2,3,8,7,290.9910428571428,2
76561198191644034,1008,9,7,1,1,0,0,8,1,5,9,8,262.55995,6
76561198092021343,369,4,4,0,0,0,0,3,1,5,4,8,609.2696,1
76561198137223515,1682,16,2,4,0,10,0,14,2,5,16,6,113.9963,7
76561198198510061,287,2,0,0,2,0,0,2,0,5,2,7,39.3836,3
76561198284004908,591,3,2,0,0,0,0,2,1,4,3,5,338.0424999999998,5
76561198310808592,269,4,2,0,0,1,1,4,0,5,4,6,169.3286666666667,3
76561198310423015,381,4,0,4,0,0,0,3,1,5,4,5,43.780333333333296,2
76561198356906177,586,6,2,2,2,0,0,4,2,4,6,7,44.19084,3
76561198081318567,1443,13,13,0,0,0,0,11,2,5,13,5,68.07215833333333,4
76561198198481829,771,6,6,0,0,0,0,4,2,5,6,4,92.98280000000004,4
76561198086347240,198,4,4,0,0,0,0,2,2,4,4,3,268.4651333333334,3
76561198129690045,214,1,0,1,0,0,0,1,0,5,1,5,0.0,3
76561198265845129,519,6,6,0,0,0,0,6,0,5,6,2,116.73800000000001,1
76561198295496769,1409,15,4,4,2,5,0,13,2,5,15,10,184.38770714285715,6
76561197960488729,1275,12,12,0,0,0,0,9,3,5,12,11,204.38854545454544,9
76561198095356715,806,9,2,6,0,1,0,9,0,5,9,12,275.10232499999995,4
76561197993917651,629,5,4,0,0,1,0,4,1,4,5,9,530.1138500000001,6
76561198096490521,1110,10,9,0,0,1,0,5,5,3,10,9,296.1577888888889,8
76561198339028147,1392,14,10,4,0,0,0,10,4,5,14,15,201.6225846153846,6
76561198032500416,1885,17,15,0,1,1,0,15,2,4,17,10,157.71636875000004,7
76561198214207976,1004,9,6,2,1,0,0,6,3,3,9,9,326.45585,5
76561198391942004,422,4,0,3,1,0,0,3,1,5,4,8,431.3483333333333,3
76561198273862765,1274,8,0,6,2,0,0,7,1,5,8,10,252.19614285714297,5
76561198021559458,283,2,0,2,0,0,0,2,0,5,2,2,180.0815,1
76561198265845129,453,3,2,0,0,0,1,3,0,5,3,2,365.24245,4
76561198157846120,641,6,5,0,1,0,0,5,1,5,6,10,199.05560000000006,4
76561198152650875,662,5,4,0,0,1,0,5,0,3,5,5,235.05775,3
76561197993696846,476,5,5,0,0,0,0,5,0,5,5,5,63.31450000000001,1
76561198331640164,441,5,0,5,0,0,0,5,0,5,5,4,65.90899999999999,1
76561198353489825,1323,12,10,1,1,0,0,12,0,4,12,3,89.30906363636365,4
76561198355823660,258,1,1,0,0,0,0,1,0,4,1,6,0.0,4
76561198360395254,258,5,0,0,0,5,0,5,0,5,5,4,134.865775,0
76561198272245090,148,1,0,0,0,1,0,1,0,5,1,4,0.0,2
76561198044028830,1415,14,9,2,1,2,0,13,1,4,14,8,143.94118461538463,4
76561198088953762,884,8,7,0,0,1,0,7,1,5,8,8,169.97542857142858,4
76561197967853724,1033,11,4,7,0,0,0,9,2,5,11,9,197.63299999999998,1
76561198216578293,643,4,2,0,0,1,0,3,1,5,4,11,136.76766666666663,5
76561198403632845,471,5,3,1,1,0,0,5,0,5,5,10,255.64932500000003,4
76561198110323714,1184,10,5,5,0,0,0,9,1,5,10,9,228.68645555555557,6
76561198179663566,734,7,2,0,1,3,1,7,0,5,7,9,337.59605000000005,4
76561198376769815,1184,11,11,0,0,0,0,7,4,5,11,8,197.57358000000002,7
76561198134434511,1037,12,5,6,0,1,0,12,0,4,12,6,183.4009090909091,7
76561198314846472,869,6,4,0,0,1,1,5,1,3,6,10,369.016,7
76561198387638294,655,7,4,1,0,2,0,7,0,5,7,5,353.8713333333333,3
76561198265845129,791,8,8,0,0,0,0,8,0,5,8,4,221.1853,4
76561198307533301,577,4,3,1,0,0,0,3,1,4,4,1,250.82979999999998,3
76561198215551664,776,9,9,0,0,0,0,6,3,3,9,4,270.8886125,4
76561198315057175,685,5,2,3,0,0,0,5,0,5,5,10,361.67205,8
76561197963978862,668,4,0,3,0,0,1,4,0,5,4,6,671.3516000000001,5
76561198362032020,519,5,1,0,0,3,1,5,0,4,5,5,524.7670249999999,6
76561198209713992,581,5,1,2,1,0,1,5,0,4,5,8,299.8814,3
76561197992206530,279,5,4,0,1,0,0,5,0,5,5,8,465.695575,1
76561198022618706,576,5,2,2,0,1,0,5,0,5,5,6,269.5642500000001,1
76561197965718016,1309,12,6,0,0,5,1,11,1,5,12,10,246.76995454545457,9
76561198096151207,863,6,6,0,0,0,0,5,1,5,6,10,346.5458000000001,10
76561198343222578,504,4,4,0,0,0,0,3,1,4,4,10,883.7054666666667,6
76561198183781390,1252,10,2,6,2,0,0,6,4,5,10,9,237.01820000000004,9
76561198082680949,952,10,9,0,1,0,0,5,5,5,10,9,230.4755444444445,9
76561197977880417,1358,11,5,6,0,0,0,8,3,5,11,7,247.75904,5
76561198265845129,839,8,7,0,0,1,0,6,2,4,8,7,384.5978714285714,8
76561197974977022,1225,12,5,2,0,2,3,9,3,5,12,9,187.20131818181818,8
76561198192101811,1432,15,13,0,2,0,0,12,3,3,15,9,190.61788571428573,5
76561198056666790,631,3,2,0,1,0,0,3,0,5,3,11,412.6245000000001,8
76561198391596967,302,1,0,1,0,0,0,1,0,5,1,8,0.0,3
76561198351939729,749,8,0,7,1,0,0,6,2,5,8,7,134.89315714285712,2
76561198103279034,530,5,4,1,0,0,0,5,0,5,5,7,233.656075,2
76561198158376008,699,6,0,5,0,1,0,5,1,5,6,8,171.1951400000001,3
76561198355264704,631,6,4,1,0,1,0,4,2,4,6,9,273.96989999999994,1
76561198358621942,665,5,2,3,0,0,0,5,0,5,5,7,338.2814,3
76561198288719917,1010,8,4,3,0,0,0,6,2,4,8,7,194.1475428571429,4
76561198305887288,863,11,11,0,0,0,0,9,2,4,11,4,155.02470999999997,1
76561198354893642,831,7,0,6,1,0,0,5,2,5,7,4,236.65436666666665,5
76561198204874117,537,7,3,0,1,3,0,7,0,5,7,3,194.62618333333333,3
76561198291068799,837,7,2,4,1,0,0,6,1,5,7,7,286.98691666666673,5
76561198095783644,1022,10,7,3,0,0,0,5,5,5,10,5,179.63554444444446,4
76561198204554161,655,3,1,0,0,0,0,2,1,5,3,7,302.744,5
76561198126691366,558,6,3,3,0,0,0,4,2,4,6,6,324.23168000000004,2
76561198344977777,256,2,0,2,0,0,0,2,0,5,2,8,84.91699999999969,1
76561198314450638,371,4,2,0,2,0,0,3,1,3,4,5,533.1663666666667,2
76561198035546721,917,6,5,0,1,0,0,5,1,4,6,6,345.16576,5
76561198369098043,631,8,5,0,1,2,0,4,4,5,8,4,249.21694285714298,3
76561198078304579,364,2,1,0,1,0,0,1,1,5,2,7,1281.1745,5
76561198255604284,1076,13,4,5,2,2,0,7,6,5,13,6,133.40096666666668,1
76561198148972890,1864,14,11,0,0,3,0,11,3,5,14,15,101.80333846153847,10
76561198069744787,1626,17,13,2,0,2,0,13,4,5,17,11,164.02208750000003,5
76561198307867061,1466,16,12,3,1,0,0,12,4,5,16,15,158.83694666666665,9
76561198136501789,1814,15,14,1,0,0,0,9,6,4,15,15,167.3652285714286,9
76561198184253553,944,7,3,0,0,4,0,7,0,5,7,16,381.74219999999997,9
76561198060524737,1367,15,9,2,1,1,0,8,7,5,15,13,176.36815714285714,7
76561198249750838,1496,16,7,1,0,7,1,13,3,4,16,15,173.088,9
76561198130558561,1355,9,5,3,0,1,0,9,0,5,9,14,258.996,14
76561198099362059,1992,17,11,5,0,1,0,14,3,4,17,13,161.50236875000004,9
76561197978936408,1729,15,13,0,1,1,0,11,4,5,15,14,169.86543571428572,8
76561198098776450,1170,10,6,4,0,0,0,10,0,5,10,6,230.93084444444452,5
76561198054125071,390,3,3,0,0,0,0,3,0,5,3,7,869.60615,6
76561198181233103,1078,10,3,7,0,0,0,9,1,4,10,9,262.2881777777778,4
76561198129696451,1022,9,6,3,0,0,0,7,2,3,9,7,293.5464875,5
76561198332104719,451,8,5,0,1,1,1,7,1,5,8,6,278.48747142857144,4
76561198009758303,820,7,6,0,0,1,0,7,0,5,7,9,148.44808333333336,3
76561198126888656,900,8,5,2,0,1,0,8,0,4,8,11,319.9160142857142,5
76561198170259214,851,8,3,4,0,1,0,7,1,5,8,5,322.6799571428572,4
76561197962594901,653,8,5,0,1,2,0,7,1,3,8,6,330.1457571428572,3
76561198106007394,538,4,4,0,0,0,0,3,1,5,4,9,455.9506666666666,3
76561198172023547,553,7,6,0,0,1,0,5,2,5,7,9,278.8681666666667,5
76561198346647293,770,9,8,0,0,1,0,7,2,5,9,7,274.6066,3
76561198380917905,1427,17,10,0,0,6,0,10,7,4,17,6,154.2024375,6
76561198129742649,1765,13,8,4,0,1,0,11,2,4,13,7,126.47216666666674,9
76561198163440810,923,10,4,6,0,0,0,6,4,5,10,7,214.74288888888887,3
76561198366488103,838,9,1,5,2,1,0,5,4,3,9,9,307.03345,3
76561198120523490,703,6,6,0,0,0,0,5,1,5,6,9,380.31678,6
76561198216797989,765,5,2,0,0,3,0,5,0,5,5,17,565.5848500000001,7
76561198377474687,884,9,5,2,0,2,0,7,2,4,9,10,308.330625,3
76561198159121615,1185,7,4,0,1,2,0,5,2,4,7,11,271.4235,8
76561198142395474,1014,8,5,0,2,1,0,2,6,3,8,6,271.1568857142857,9
76561198397692563,644,5,5,0,0,0,0,5,0,5,5,7,320.329525,7
76561198073032277,1029,10,6,4,0,0,0,8,2,4,10,8,232.1287333333334,3
76561198314126139,726,8,2,4,2,0,0,6,2,5,8,8,250.85912857142858,1
76561198256914384,1043,11,11,0,0,0,0,6,5,5,11,7,135.2109,3
76561198199159602,1001,11,6,2,1,1,1,8,3,5,11,6,208.35948000000002,6
76561198354484371,996,9,3,4,0,2,0,6,3,4,9,9,237.9382375,2
76561198265845129,853,7,5,0,2,0,0,6,1,4,7,8,261.9665,7
76561198209454343,959,7,3,3,0,0,1,5,2,5,7,9,275.61441666666667,6
76561198298262784,208,2,2,0,0,0,0,1,1,3,2,10,781.1175,1
76561197961237229,371,5,5,0,0,0,0,4,1,3,5,4,388.168325,3
76561198016317631,363,2,2,0,0,0,0,2,0,5,2,3,9.032999999999902,3
76561197994373881,648,5,1,1,1,1,0,4,1,5,5,5,397.505925,4
76561198067080146,296,3,1,2,0,0,0,3,0,5,3,3,619.2282499999999,2
76561198193825577,353,3,3,0,0,0,0,2,1,4,3,5,126.47724999999997,1
76561198142837226,306,2,2,0,0,0,0,2,0,5,2,5,16.53449999999998,3
76561197980160176,306,4,1,2,1,0,0,3,1,4,4,3,517.3596333333334,1
76561198164588981,508,6,5,0,1,0,0,5,1,5,6,4,276.35303999999996,2
76561198001998716,522,6,6,0,0,0,0,4,2,4,6,3,309.83448,3
76561198010326578,446,2,2,0,0,0,0,2,0,5,2,3,9.220000000000027,5
76561198129954064,386,3,0,2,0,1,0,3,0,3,3,6,87.83025000000004,3
76561198350774628,817,8,3,1,4,0,0,8,0,5,8,4,261.3790714285714,4
76561198205158431,813,5,2,0,2,1,0,5,0,5,5,7,408.391025,7
76561198262664486,618,8,5,2,1,0,0,8,0,5,8,4,156.84971428571427,4
76561198383994137,851,11,8,1,0,2,0,7,4,3,11,3,152.64155,5
76561198030130660,340,1,0,1,0,0,0,1,0,5,1,7,0.0,5
76561198265845129,665,5,3,0,2,0,0,5,0,5,5,6,372.23445,5
76561198009778776,639,6,3,2,0,1,0,6,0,4,6,6,365.73668000000004,3
76561198203063378,438,6,1,3,1,1,0,5,1,4,6,8,302.36118,4
76561198158037664,720,5,3,0,1,1,0,5,0,5,5,7,185.09274999999997,4
76561198125956085,294,4,2,2,0,0,0,2,2,5,4,4,193.19166666666675,1
76561198164939337,489,5,2,1,1,0,0,5,0,5,5,7,408.6061,0
76561198129789183,443,3,3,0,0,0,0,3,0,4,3,5,483.54145000000005,3
76561198051064117,348,2,2,0,0,0,0,2,0,3,2,4,11.002099999999984,3
76561198249032908,151,1,0,0,0,1,0,0,1,5,1,5,0.0,1
76561198154929107,812,8,7,1,0,0,0,7,1,5,8,4,143.11994285714286,2
76561198073132538,329,3,1,2,0,0,0,3,0,4,3,3,191.42565000000002,1
76561198058793457,215,3,3,0,0,0,0,3,0,5,3,3,641.9612999999999,2
76561198039190312,822,10,9,0,1,0,0,9,1,3,10,1,173.4241,1
76561198123077384,270,1,0,1,0,0,0,1,0,5,1,4,0.0,4
76561198398248410,1164,11,5,0,0,6,0,11,0,5,11,6,142.79934999999998,3
76561198170266238,1227,8,7,0,0,1,0,6,2,5,8,6,243.85317142857141,8
76561198119269190,666,12,9,1,0,2,0,11,1,4,12,6,154.99457272727273,1
76561198165453143,907,8,2,6,0,0,0,6,2,3,8,2,186.02758571428572,3
76561198302097253,215,3,0,1,2,0,0,2,1,4,3,3,621.98285,2
76561198360384603,828,5,3,1,0,1,0,5,0,4,5,9,300.778975,7
76561198403842994,1010,11,5,3,1,2,0,11,0,5,11,8,157.97652,2
76561198044028830,415,2,2,0,0,0,0,2,0,5,2,8,611.7785000000001,5
76561198389351528,200,3,1,1,0,1,0,3,0,4,3,8,329.0173,1
76561198389362035,350,2,2,0,0,0,0,2,0,5,2,9,980.8331000000001,3
76561198053550638,769,6,4,2,0,0,0,6,0,4,6,10,383.35002000000003,6
76561198123678691,943,9,0,6,1,1,0,9,0,5,9,10,267.08557500000006,6
76561198030716760,1212,11,10,0,1,0,0,11,0,4,11,11,227.88857,5
76561197997327649,824,7,7,0,0,0,0,5,2,3,7,8,376.5193666666667,5
76561198115656868,789,7,6,0,0,0,1,6,1,5,7,8,327.998,8
76561198131143467,1130,11,5,5,1,0,0,10,1,5,11,9,164.31387,5
76561198007773975,1230,13,4,9,0,0,0,11,2,4,13,6,192.36266666666666,1
76561198190686831,681,6,5,1,0,0,0,5,1,5,6,9,428.46930000000003,7
76561198351748712,718,8,6,0,0,2,0,8,0,4,8,7,307.3408857142858,2
76561197970351383,976,8,8,0,0,0,0,7,1,5,8,8,150.47757142857145,5
76561198324660393,1579,14,6,5,1,2,0,12,2,5,14,6,159.27146923076924,3
76561198309882411,349,3,2,0,0,1,0,3,0,4,3,7,769.10245,4
76561198239421024,876,11,3,7,0,1,0,7,4,3,11,5,208.24084000000002,4
76561197999224851,735,7,4,2,0,1,0,7,0,3,7,7,296.90118333333334,2
76561198050004859,969,9,8,0,0,1,0,8,1,5,9,3,182.26462500000002,4
76561198033572230,691,5,2,2,0,1,0,5,0,5,5,9,492.35867499999995,5
76561198200432637,916,7,4,1,0,2,0,3,4,4,7,8,344.34325000000007,7
76561198122031759,508,4,4,0,0,0,0,3,1,5,4,9,361.04123333333337,4
76561198355734954,717,6,2,3,1,0,0,3,3,4,6,8,385.19048,4
76561198043711032,864,6,4,2,0,0,0,6,0,5,6,10,391.78014,6
76561198389850208,395,9,4,0,0,5,0,7,2,5,9,17,74.878625,7
76561198356665651,1698,19,13,1,0,5,0,16,3,4,19,14,105.65426666666666,9
76561198362300175,1769,19,15,2,2,0,0,14,5,5,19,12,102.45885555555554,8
76561198403033473,472,5,4,0,0,0,1,3,2,5,5,13,374.85850000000005,5
76561198398731937,1484,14,0,1,2,11,0,13,1,5,14,15,160.01593076923078,6
76561198317749624,2117,18,13,0,2,1,0,12,6,5,18,10,132.71028235294116,10
76561198044028830,2525,20,8,5,1,6,0,18,2,5,20,22,109.84329473684211,15
76561198179788711,40,0,0,0,0,0,0,0,0,0,0,3,0.0,1
76561198205085235,1728,19,3,4,0,12,0,16,3,5,19,12,83.0466111111111,5
76561198080954634,1262,13,3,4,2,1,0,10,3,4,13,18,130.5613333333333,4
76561198029213438,505,3,3,0,0,0,0,3,0,5,3,10,426.46164999999996,4
76561198068964788,735,7,4,1,0,2,0,4,3,4,7,6,223.41001666666668,4
76561198139897280,681,5,2,3,0,0,0,4,1,5,5,7,196.37599999999998,4
76561198344546432,253,1,0,0,0,1,0,1,0,4,1,7,0.0,3
76561198196384353,755,8,5,1,0,2,0,7,1,5,8,4,140.9616714285714,1
76561198344801818,437,4,3,0,0,1,0,3,1,5,4,5,150.78069999999994,2
76561198103361461,1222,15,3,8,3,0,0,9,6,5,15,3,101.92925000000001,1
76561198081376893,687,5,3,1,1,0,0,5,0,5,5,7,314.09507499999995,4
76561198003169955,723,6,4,1,0,1,0,4,2,4,6,4,278.93804,3
76561198093583803,401,4,3,0,1,0,0,3,1,5,4,5,18.910000000000007,1
76561198232979476,1358,10,1,4,0,4,0,10,0,5,10,9,155.75255555555555,9
76561198044028830,1823,14,10,0,1,3,0,12,2,5,14,9,85.99851538461537,9
76561198320215311,1291,17,3,11,3,0,0,13,4,5,17,6,64.71285,2
76561198167840306,669,5,3,0,0,2,0,3,2,5,5,6,369.071,7
76561198388948721,934,11,10,0,0,1,0,7,4,4,11,8,156.49851,8
76561198078232895,1449,16,15,1,0,0,0,11,5,4,16,10,102.31327333333334,5
76561198093912008,548,5,1,1,3,0,0,5,0,5,5,11,278.1825,3
76561198022609601,591,4,4,0,0,0,0,4,0,5,4,12,442.12909999999994,3
76561198192789042,567,4,0,0,0,4,0,2,2,3,4,12,96.32696666666668,8
76561198343917579,1297,10,0,0,0,10,0,9,1,5,10,13,84.63066666666666,6
76561198026006026,985,11,5,5,0,0,1,7,4,5,11,12,201.19222,4
76561198101890753,1126,10,9,0,1,0,0,9,1,5,10,11,260.9101,7
76561198045995334,1509,14,7,5,0,2,0,7,7,3,14,11,199.26677692307697,5
76561198076686755,1138,10,6,3,0,1,0,8,2,3,10,10,244.1629777777778,7
76561198075467556,814,5,5,0,0,0,0,5,0,5,5,12,408.09824999999995,8
76561197985025852,1166,11,9,2,0,0,0,8,3,5,11,10,241.37377999999998,7
76561198340772764,1704,16,1,15,0,0,0,15,1,5,16,9,172.49158666666665,7
76561198030420743,939,8,8,0,0,0,0,4,4,4,8,11,314.7901142857142,6
76561197975897516,1416,12,11,0,1,0,0,8,4,4,12,11,239.1173,7
76561198043681956,940,9,9,0,0,0,0,6,3,5,9,9,291.69142500000004,5
76561198275122088,313,2,0,1,0,1,0,2,0,3,2,4,420.42640000000006,4
76561198183936122,300,3,2,0,0,1,0,3,0,5,3,5,687.78085,0
76561198195479171,365,3,3,0,0,0,0,3,0,5,3,4,23.427999999999884,3
76561198301914926,542,6,2,4,0,0,0,6,0,4,6,4,288.49088,1
76561198283763865,500,3,1,2,0,0,0,3,0,4,3,5,500.58919999999995,4
76561198265845129,331,1,1,0,0,0,0,1,0,4,1,5,0.0,5
76561197992534172,571,7,7,0,0,0,0,4,3,5,7,2,65.91376666666666,2
76561198085988802,323,4,1,2,0,0,1,4,0,5,4,5,384.82323333333335,1
76561198018316597,435,7,6,0,0,1,0,7,0,5,7,2,186.2954,2
76561198014435427,485,3,3,0,0,0,0,3,0,5,3,3,25.101,2
76561198075198563,1045,11,11,0,0,0,0,7,4,5,11,7,226.60862000000003,5
76561198370716384,887,8,3,3,2,0,0,8,0,5,8,14,198.90657142857145,7
76561198206916311,236,1,0,0,1,0,0,1,0,5,1,4,0.0,3
76561198268205060,1459,15,15,0,0,0,0,15,0,3,15,10,190.1658857142857,6
76561198161399734,956,8,7,0,0,1,0,6,2,5,8,16,315.34091428571435,8
76561198027371005,737,12,7,4,0,0,1,12,0,5,12,8,236.35209090909086,3
76561198219183192,1337,15,14,1,0,0,0,15,0,5,15,10,192.7870142857143,4
76561198142001173,694,6,4,1,0,1,0,6,0,4,6,10,408.83944,7
76561198009328878,952,15,15,0,0,0,0,13,2,4,15,5,195.49959285714286,3
76561198196384353,697,3,0,1,1,0,1,3,0,3,3,10,1321.06555,6
76561198265845129,1342,13,12,0,1,0,0,9,4,5,13,7,174.96349166666667,5
76561198061119274,731,6,0,3,1,0,0,3,3,4,6,7,294.19714,3
76561198272781119,1427,19,10,7,0,2,0,19,0,3,19,8,97.5330611111111,3
76561198211913699,907,9,8,0,0,0,1,5,4,5,9,5,189.40362500000003,5
76561198274370468,708,9,9,0,0,0,0,9,0,5,9,7,174.05225000000002,5
76561198324698193,930,7,5,1,1,0,0,7,0,5,7,16,294.05411666666663,6
76561198130672581,1087,11,9,2,0,0,0,5,6,5,11,9,137.96508999999998,4
76561198305034049,1241,11,7,0,4,0,0,8,3,4,11,12,205.39408000000003,7
76561198365651322,253,2,2,0,0,0,0,2,0,5,2,6,12.390999999999849,3
76561198322647888,718,3,2,0,0,1,0,2,1,5,3,13,420.4534,8
76561198267381920,1115,12,11,0,1,0,0,10,2,5,12,4,105.69253636363636,4
76561198347556192,908,9,6,2,1,0,0,8,1,5,9,6,235.6171625,3
76561198213828661,600,10,8,0,0,2,0,5,5,4,10,5,212.88256666666678,3
76561198293468457,476,3,3,0,0,0,0,3,0,5,3,5,690.1257,5
76561198265845129,494,6,5,0,1,0,0,4,2,3,6,3,391.54638,2
76561198322153521,419,2,2,0,0,0,0,1,1,5,2,6,29.47410000000002,6
76561198166228882,831,9,9,0,0,0,0,4,5,5,9,12,251.17077499999996,2
76561198240073354,721,5,2,2,1,0,0,5,0,5,5,11,416.357025,6
76561198127644758,449,4,4,0,0,0,0,3,1,4,4,8,641.3148333333334,3
76561198014597048,249,4,2,0,1,0,1,3,1,3,4,4,226.23906666666667,0
76561198054287217,1359,14,11,0,0,3,0,10,4,5,14,10,143.21694615384615,6
76561198195916081,383,2,2,0,0,0,0,2,0,5,2,10,1711.6635999999999,9
76561198265845129,1814,20,18,0,1,1,0,11,9,4,20,6,108.67234210526318,8
76561198093471116,1355,12,7,5,0,0,0,12,0,5,12,9,150.09193636363636,6
76561198013073900,1023,7,2,0,0,5,0,7,0,4,7,9,328.1838666666667,8
76561198295993966,703,6,2,3,1,0,0,5,1,5,6,11,330.00840000000005,5
76561198275805181,925,9,2,4,1,1,1,6,3,5,9,12,260.162325,5
76561198562891029,749,6,2,0,2,2,0,2,4,5,6,10,292.61612,4
76561198106564321,1198,9,8,0,1,0,0,5,4,4,9,11,256.9975625,9
76561198371488699,1496,14,8,0,1,4,0,8,6,4,14,11,125.94646923076924,8
76561198220621377,922,8,0,5,1,2,0,6,2,5,8,9,281.7597285714286,4
76561198032614041,805,9,2,7,0,0,0,5,4,5,9,8,248.7432875,2
76561198078097259,1244,9,6,0,0,1,0,8,1,4,9,13,213.3977,8
76561198067775261,882,8,6,0,2,0,0,6,2,4,8,10,144.8805,5
76561197987170694,443,4,4,0,0,0,0,4,0,5,4,7,159.1299333333333,2
76561198117462464,900,8,5,3,0,0,0,5,3,4,8,9,260.81,6
76561198136636527,254,1,1,0,0,0,0,0,1,3,1,10,0.0,5
76561197975154975,803,7,2,5,0,0,0,4,3,5,7,6,153.4675,7
76561198279622998,957,9,8,1,0,0,0,8,1,5,9,6,221.0278625,3
76561198048066167,1888,22,21,0,0,0,1,21,1,5,22,7,85.96922380952381,5
76561198388728465,664,4,2,0,0,2,0,4,0,5,4,10,248.9913333333333,6
76561198129807746,1421,18,7,1,0,6,0,18,0,5,18,10,121.35442941176473,5
76561198265845129,1200,14,9,0,1,3,1,13,1,4,14,9,135.25456153846153,6
76561198257054474,780,7,4,1,0,1,1,6,1,5,7,10,286.80485000000004,6
76561198299838149,1121,15,6,1,0,8,0,12,3,4,15,8,129.59919285714287,5
76561198133582799,1430,16,9,2,4,1,0,14,2,5,16,12,145.97924666666668,3
76561198196827942,1519,12,9,2,0,1,0,10,2,5,12,14,169.95157272727272,6
76561198271865733,163,1,0,0,1,0,0,0,1,4,1,2,0.0,2
76561198302366680,1188,10,5,1,1,2,0,9,1,4,10,13,199.79262222222223,9
76561198165549701,788,8,6,0,1,0,0,6,2,5,8,17,261.64547142857145,3
76561198190494855,1523,14,7,3,3,0,0,11,3,5,14,13,160.0562076923077,8
76561198111388500,1097,11,9,0,2,0,0,6,5,4,11,10,206.96048000000002,7
76561198288872611,871,5,4,0,0,1,0,4,1,5,5,12,102.15674999999999,10
76561198027895878,880,7,4,3,0,0,0,4,3,5,7,9,151.41855,7
76561198301915866,830,6,4,0,1,0,1,4,2,5,6,12,260.65860000000004,8
76561198195520171,877,9,6,0,0,3,0,8,1,5,9,9,193.6797625,5
76561198044637170,2295,24,14,9,1,0,0,19,5,5,24,11,95.38134347826085,5
76561198010944320,964,10,2,7,1,0,0,8,2,4,10,7,244.33219999999997,4
76561198337989587,826,8,6,2,0,0,0,5,3,3,8,9,254.29731428571426,4
76561198081402455,819,5,5,0,0,0,0,4,1,5,5,7,386.05472499999996,6
76561198265845129,1546,14,14,0,0,0,0,13,1,4,14,6,184.53973076923074,9
76561198190719461,1107,12,9,2,1,0,0,10,2,5,12,9,137.70666363636363,6
76561198342931982,929,5,2,1,1,1,0,5,0,4,5,13,556.5779750000002,10
76561198299734422,1121,11,4,5,0,2,0,9,2,3,11,9,222.56246000000002,5
76561198199590181,961,12,1,8,3,0,0,8,4,5,12,10,198.18990909090908,3
76561197969649246,1231,10,3,5,1,1,0,7,3,5,10,10,178.05911111111106,8
76561198189326947,1616,15,12,1,0,1,1,14,1,5,15,13,161.35730000000007,8
76561198244975462,794,5,1,4,0,0,0,4,1,5,5,12,574.1733499999999,7
76561198342639446,1130,9,8,0,0,1,0,7,2,5,9,9,286.9500125,10
76561198201827630,848,8,4,3,1,0,0,8,0,3,8,10,341.69414285714294,5
76561198155115183,2085,22,10,11,0,0,1,20,2,5,22,10,106.0711761904762,5
76561198065350259,1127,6,6,0,0,0,0,4,2,5,6,10,379.49786000000006,11
76561198116792975,1092,9,6,2,0,1,0,9,0,3,9,11,280.0854750000001,6
76561198078958929,598,7,3,4,0,0,0,7,0,3,7,12,370.00413333333336,3
76561197965248702,1106,11,5,6,0,0,0,11,0,5,11,13,173.85346,2
76561198148960198,1618,13,5,7,0,0,0,12,1,5,13,10,188.075325,10
76561198009026402,1111,10,8,0,0,2,0,9,1,4,10,13,248.98559999999998,7
76561198105591585,1079,11,8,1,2,0,0,11,0,4,11,12,203.79113,4
76561198021905094,1012,10,2,6,2,0,0,9,1,2,10,9,248.76338888888893,3
76561198001109764,1241,12,2,4,0,3,1,12,0,5,12,11,181.35796363636362,5
76561198329496267,706,9,3,3,0,3,0,4,5,5,9,4,156.42021250000002,0
76561198345924259,655,4,3,0,1,0,0,3,1,4,4,5,264.1659333333334,3
76561198059345332,373,4,4,0,0,0,0,2,2,4,4,6,129.10726666666665,3
76561198047479948,434,5,3,2,0,0,0,5,0,5,5,6,107.21945,2
76561198259613266,408,4,3,0,0,0,1,2,2,5,4,7,392.1685333333333,1
76561198069457264,447,3,1,2,0,0,0,3,0,4,3,7,163.70574999999997,4
76561198059257253,508,4,4,0,0,0,0,3,1,5,4,3,240.49576666666664,2
76561198203826021,296,4,3,1,0,0,0,2,2,5,4,6,168.3178333333333,3
76561198260331595,1024,10,3,4,3,0,0,5,5,3,10,4,135.72571111111108,3
76561198039573000,495,6,1,3,1,1,0,5,1,4,6,5,235.51992,0
76561198076686755,1141,12,8,3,0,0,0,8,4,5,12,4,139.61514545454543,3
76561198045995334,703,4,4,0,0,0,0,3,1,5,4,8,293.52099999999996,10
76561198101890753,1002,10,10,0,0,0,0,7,3,5,10,3,189.99897777777775,2
76561198051053543,429,5,2,3,0,0,0,4,1,4,5,6,286.11585,3
76561198049586946,575,6,1,4,1,0,0,5,1,5,6,7,155.4708,3
76561198168198835,1374,15,8,7,0,0,0,10,5,5,15,6,122.07077142857142,1
76561198368450351,736,6,6,0,0,0,0,4,2,3,6,7,325.63217999999995,7
76561198163593527,185,1,1,0,0,0,0,1,0,4,1,8,0.0,4
76561198258260987,143,1,1,0,0,0,0,1,0,5,1,9,0.0,2
76561198052142353,600,5,2,2,0,1,0,3,2,5,5,7,162.04250000000002,3
76561198320494641,1746,30,4,11,14,0,1,23,7,4,30,8,69.20301379310344,4
76561198097823848,1884,28,17,3,0,7,1,24,4,5,28,8,71.55894444444445,5
76561198316457598,1300,27,12,0,2,13,0,16,11,4,27,9,89.41628846153846,5
76561198272395428,755,6,0,2,0,4,0,4,2,3,6,12,436.63410000000005,2
76561198058026305,1445,24,12,2,0,9,0,11,13,5,24,10,90.03504347826087,5
76561198198623573,1446,14,4,6,0,1,0,12,2,5,14,41,163.1396076923077,8
76561198067959014,1723,9,4,1,1,2,0,8,1,4,9,34,261.9411875,13
76561198262797486,2104,18,10,0,4,2,0,15,3,5,18,33,93.93535294117646,7
76561198074564559,317,4,0,4,0,0,0,4,0,5,4,3,122.73200000000001,0
76561198035202533,181,0,0,0,0,0,0,0,0,0,0,2,0.0,2
76561198262746883,969,8,4,2,1,1,0,7,1,4,8,11,244.92174285714285,5
76561198092221856,1007,6,1,3,2,0,0,5,1,5,6,11,293.0379,6
76561198395111173,768,9,7,0,0,2,0,5,4,4,9,9,237.2010125,6
76561198289772331,943,10,9,1,0,0,0,7,3,5,10,9,166.81003333333334,3
76561198288112452,768,7,1,3,0,3,0,6,1,5,7,10,288.47156666666666,4
76561198284695128,1046,10,8,0,0,1,1,7,3,5,10,7,211.8663888888889,6
76561198059257253,1542,14,8,0,0,6,0,12,2,5,14,9,160.44353076923076,3
76561198074890208,1299,12,10,2,0,0,0,11,1,5,12,6,160.18665454545456,7
76561198330021072,942,10,5,4,1,0,0,7,3,5,10,8,132.9292222222222,6
76561198039573000,619,4,3,1,0,0,0,4,0,5,4,10,411.0710000000001,5
76561198152219899,1006,10,5,4,1,0,0,5,5,5,10,8,235.08931111111113,3
76561198116911347,407,4,2,2,0,0,0,4,0,5,4,12,245.36546666666663,2
76561198220003561,309,2,2,0,0,0,0,2,0,5,2,11,1074.3110000000001,3
76561198138501420,939,9,8,0,0,0,1,9,0,4,9,9,183.6725125,4
76561198251777422,620,6,4,1,0,1,0,5,1,3,6,8,435.1880000000002,3
76561198126509239,880,10,6,4,0,0,0,9,1,5,10,7,205.69534444444443,2
76561198038257958,597,7,6,1,0,0,0,7,0,4,7,5,369.20455,2
76561198099645129,1131,10,5,1,4,0,0,6,4,3,10,7,233.24524444444444,7
76561198035928854,1037,10,10,0,0,0,0,7,3,2,10,6,235.02336666666667,7
76561198164241083,1149,11,6,5,0,0,0,10,1,5,11,6,175.45224,5
76561198099416090,1126,10,5,1,4,0,0,9,1,5,10,11,166.64124444444442,6
76561198128286567,689,4,0,2,0,2,0,3,1,4,4,9,603.3816666666667,9
76561198306316604,986,11,5,2,3,0,1,9,2,5,11,9,194.722,6
76561198156191599,737,5,5,0,0,0,0,4,1,4,5,10,389.827025,6
76561198408176090,636,7,4,0,0,3,0,5,2,5,7,10,132.80466666666666,6
76561198067350388,988,10,5,1,1,3,0,8,2,5,10,6,191.50126666666665,6
76561198079787044,1169,12,4,4,3,1,0,12,0,5,12,6,180.17656363636365,2
76561198118883833,1061,8,6,0,1,1,0,8,0,4,8,9,274.1828571428572,8
76561198242585706,1315,14,5,5,2,2,0,14,0,5,14,9,141.67964615384616,3
76561198234008484,585,5,1,0,2,2,0,3,2,5,5,7,358.7536,3
76561198059389665,845,12,9,1,2,0,0,12,0,5,12,9,164.99460909090908,3
76561198393555990,513,5,1,2,1,1,0,5,0,5,5,9,226.41039999999998,1
76561198107438341,1361,14,6,8,0,0,0,14,0,4,14,7,162.1079307692308,4
76561198116788806,917,9,9,0,0,0,0,9,0,3,9,8,199.4561,6
76561198169883618,534,10,3,0,0,7,0,3,7,3,10,8,270.80872222222223,3
76561198273331165,225,2,2,0,0,0,0,2,0,5,2,2,6.563799999999901,1
76561198152323320,863,10,0,9,0,1,0,10,0,4,10,13,273.09046666666677,3
76561197970546340,898,8,8,0,0,0,0,7,1,5,8,10,269.92211428571443,6
76561198347797266,1263,9,7,1,0,1,0,8,1,5,9,11,238.86596250000002,9
76561198217629917,1150,12,11,0,0,1,0,12,0,5,12,14,189.18393636363635,3
76561198168686837,1123,11,1,9,1,0,0,11,0,5,11,6,139.97219,2
76561198395953285,1043,9,3,5,0,0,0,9,0,5,9,5,195.4846,5
76561198395845187,662,5,1,1,2,1,0,5,0,4,5,8,402.29935,5
76561198280021850,941,9,2,5,0,0,0,8,1,4,9,7,213.808125,5
76561198251985622,1113,12,3,5,2,2,0,12,0,3,12,5,158.32406363636366,3
76561197961424834,1329,14,8,5,1,0,0,14,0,5,14,10,124.76289230769228,2
76561198068609350,679,4,1,0,2,0,0,4,0,5,4,10,585.8976666666666,5
76561198055675563,687,4,1,2,0,0,0,4,0,5,4,8,484.33746666666667,5
76561198063781152,482,5,5,0,0,0,0,5,0,4,5,8,357.44747500000005,4
76561198119450462,437,4,4,0,0,0,0,4,0,5,4,10,176.51100000000005,3
76561198044028830,1354,13,10,0,1,2,0,10,3,5,13,12,233.07246666666666,8
76561198371818989,1353,12,8,0,0,4,0,8,4,5,12,10,221.97384545454543,4
76561198069071821,1360,13,6,7,0,0,0,10,3,3,13,7,235.5572666666667,4
76561198015256577,1154,8,2,3,0,3,0,8,0,3,8,11,398.59270000000004,5
76561198291896214,723,10,6,4,0,0,0,4,6,5,10,8,240.1813333333333,5
76561198253354800,1135,12,9,0,0,3,0,11,1,5,12,11,247.95575454545462,4
76561198343030999,843,9,5,0,1,3,0,6,3,5,9,12,248.27433749999997,4
76561198216860740,1209,9,9,0,0,0,0,8,1,4,9,11,250.3137375000001,9
76561198215479508,1184,9,6,0,2,1,0,5,4,4,9,10,342.25181249999997,8
76561198265932987,912,8,2,5,1,0,0,6,2,5,8,11,346.29334285714293,4
76561198274525860,607,6,6,0,0,0,0,6,0,5,6,5,204.67185999999998,3
76561198134417664,436,3,1,0,0,2,0,3,0,4,3,7,449.68315000000007,6
76561198315249186,597,3,0,3,0,0,0,2,1,5,3,5,316.09385000000003,3
76561198367497682,704,9,2,4,2,0,0,8,1,5,9,3,88.91995,1
76561198174874145,540,6,6,0,0,0,0,6,0,4,6,7,122.66182000000003,2
76561198159026711,348,2,1,0,0,1,0,2,0,5,2,6,424.241,5
76561198159615315,937,8,6,2,0,0,0,8,0,5,8,6,191.27908571428566,4
76561198181576546,659,8,7,0,0,0,1,8,0,5,8,6,106.76228571428574,3
76561198032882960,360,2,0,2,0,0,0,0,2,5,2,4,5.282199999999989,7
76561198297620274,728,7,7,0,0,0,0,6,1,4,7,5,221.93478333333334,3
76561198263246588,1496,18,12,3,2,0,1,13,5,5,18,6,130.97582941176472,4
76561198097950088,1380,14,14,0,0,0,0,13,1,4,14,9,160.93905384615385,3
76561198169461322,1040,8,7,0,0,1,0,3,5,5,8,10,258.6658428571428,6
76561198308646343,793,9,7,1,1,0,0,5,4,5,9,10,225.6448875,3
76561198119772943,326,1,1,0,0,0,0,0,1,4,1,10,0.0,6
76561198381957656,1119,12,11,0,0,1,0,8,4,5,12,10,133.43209090909093,6
76561198291211879,614,5,1,1,1,2,0,4,1,5,5,6,551.903825,6
76561197989967245,1357,12,11,0,0,1,0,11,1,5,12,12,135.78216363636363,9
76561198259600649,1021,6,2,3,0,1,0,5,1,4,6,10,432.70808,7
76561198402781593,908,9,3,6,0,0,0,9,0,4,9,11,201.76715000000002,4
76561198315871168,358,2,2,0,0,0,0,2,0,5,2,3,23.22199999999998,4
76561198044028830,373,4,3,0,0,1,0,4,0,5,4,4,241.0747,1
76561198165224075,500,5,1,4,0,0,0,5,0,4,5,1,207.80997500000004,0
76561198053560488,310,5,5,0,0,0,0,3,2,4,5,2,190.4558,1
76561198055767051,159,5,5,0,0,0,0,2,3,4,5,1,139.30045,0
76561198310789542,31,0,0,0,0,0,0,0,0,0,0,1,0.0,1
76561198168904636,542,4,0,2,0,2,0,3,1,5,4,9,286.3311,2
76561198310912713,226,1,0,1,0,0,0,1,0,5,1,4,0.0,3
76561198085094068,169,2,2,0,0,0,0,2,0,3,2,4,242.22080000000005,0
76561198042358862,272,4,1,3,0,0,0,3,1,5,4,3,172.2737,0
76561198091313266,1659,15,11,0,2,2,0,14,1,5,15,13,151.7901,5
76561198168366544,1001,9,8,0,1,0,0,5,4,5,9,10,224.00147499999997,8
76561198074910127,1156,13,1,7,0,5,0,12,1,4,13,13,145.89039166666666,5
76561198327378915,1288,11,10,0,1,0,0,11,0,3,11,14,182.78050000000002,7
76561198323763317,856,7,3,3,1,0,0,6,1,5,7,12,302.23235000000005,7
76561198254767030,1586,11,9,1,1,0,0,10,1,5,11,11,185.59079,8
76561198283258839,1054,9,8,0,0,1,0,9,0,4,9,13,230.60528750000003,7
76561198322622207,1450,14,8,0,0,6,0,13,1,5,14,12,154.54977692307693,7
76561198280287817,1333,15,5,9,1,0,0,12,3,5,15,8,142.85405714285716,2
76561198277368491,1148,13,13,0,0,0,0,7,6,5,13,11,82.31691666666667,5
76561198198336233,764,4,1,1,0,2,0,2,2,3,4,10,297.1075666666666,7
76561197979195872,848,9,1,0,0,8,0,7,2,5,9,8,121.6217375,3
76561198037815298,1053,11,7,2,0,2,0,9,2,4,11,9,116.40987,5
76561197996142491,1015,7,1,2,0,4,0,6,1,5,7,7,133.2623,7
76561198244836564,658,7,5,2,0,0,0,6,1,5,7,9,125.81714999999998,5
76561198062982411,956,9,6,2,0,1,0,8,1,5,9,7,148.51726250000002,6
76561198112566234,1279,13,12,0,0,1,0,8,5,4,13,7,75.43351666666668,4
76561198170262686,693,8,8,0,0,0,0,3,5,3,8,7,162.1645428571429,3
76561198117880787,966,6,4,0,2,0,0,5,1,5,6,7,212.61938,7
76561198180347630,587,6,3,1,0,2,0,5,1,5,6,9,175.01972,2
76561198155115183,1280,12,3,9,0,0,0,9,3,4,12,10,180.38575454545455,7
76561198069423549,895,9,1,5,1,2,0,8,1,5,9,11,286.4711,4
76561198218793591,417,3,2,0,0,0,1,2,1,5,3,12,370.17825,8
76561198049856597,1569,13,9,1,3,0,0,11,2,5,13,12,164.2571,8
76561198078958929,1023,8,2,6,0,0,0,5,3,5,8,12,283.82502857142856,6
76561198139289030,901,8,8,0,0,0,0,7,1,3,8,9,290.5226857142857,5
76561198154013791,1627,14,6,6,1,1,0,13,1,5,14,10,183.56056923076923,8
76561198241698208,1329,13,10,3,0,0,0,11,2,4,13,9,189.368525,4
76561198260016243,1293,12,11,0,0,0,1,10,2,4,12,9,212.99120909090908,5
76561197985015284,999,10,6,2,1,1,0,7,3,5,10,8,245.08715555555557,5
76561198118625441,1082,14,6,7,1,0,0,12,2,5,14,4,129.3632153846154,0
76561198118697292,309,1,1,0,0,0,0,1,0,5,1,6,0.0,6
76561198007196079,778,6,6,0,0,0,0,5,1,4,6,6,236.53246,6
76561198075457025,640,4,4,0,0,0,0,2,2,3,4,6,545.5700666666668,8
76561198254474721,708,9,4,5,0,0,0,7,2,5,9,5,123.63941249999999,3
76561198210196488,416,2,0,1,1,0,0,1,1,5,2,7,676.4139999999998,6
76561198149109808,1226,11,11,0,0,0,0,6,5,4,11,7,164.67136999999997,4
76561198137992276,767,9,8,0,0,0,1,6,3,3,9,6,91.74883750000001,5
76561198156317090,448,2,1,1,0,0,0,1,1,5,2,8,497.55899999999997,6
76561197984570432,288,3,2,1,0,0,0,3,0,5,3,6,400.95674999999994,4
76561198104625010,848,6,4,2,0,0,0,5,1,5,6,11,383.38926000000004,5
76561198278396551,844,8,6,0,1,1,0,3,5,4,8,10,286.83435714285713,7
76561198216628117,783,4,0,3,1,0,0,3,1,5,4,10,50.06290000000001,8
76561197966163000,1058,11,5,3,0,3,0,6,5,3,11,10,229.5591,4
76561198134772454,1082,10,9,0,0,1,0,10,0,5,10,11,187.544,9
76561197995044370,1198,9,8,0,0,1,0,8,1,5,9,8,299.803225,6
76561198277789367,1343,14,6,7,0,1,0,12,2,4,14,9,180.04860769230768,5
76561198139897333,1099,12,9,1,0,2,0,11,1,3,12,7,185.65097272727274,2
76561198346183478,802,8,8,0,0,0,0,7,1,5,8,8,321.04265714285714,3
76561198188408111,1065,9,7,0,0,2,0,7,2,5,9,7,130.11012500000004,4
76561198108312535,911,6,4,1,0,1,0,6,0,5,6,7,288.12622,7
76561197992531569,986,12,5,7,0,0,0,12,0,5,12,6,160.32048181818183,1
76561198364373595,1076,5,3,0,0,2,0,3,2,5,5,5,284.58129999999994,8
76561198262601242,504,7,4,1,0,1,0,5,2,4,7,4,298.3585166666667,3
76561198367582743,699,8,8,0,0,0,0,6,2,3,8,5,247.6903285714286,3
76561198161626984,583,5,0,4,1,0,0,5,0,5,5,9,149.37732499999998,5
76561198078011124,864,6,6,0,0,0,0,5,1,5,6,7,314.55858,6
76561198136856601,447,3,1,0,1,1,0,2,1,4,3,7,355.8713499999999,4
76561198167278411,966,10,10,0,0,0,0,7,3,4,10,7,185.9697888888889,4
76561198084384349,435,3,3,0,0,0,0,3,0,5,3,8,750.5872,6
76561198044028830,387,3,3,0,0,0,0,2,1,5,3,2,534.4077500000001,4
76561198244174982,720,7,6,0,0,1,0,7,0,4,7,2,172.40013333333334,3
76561198338704986,551,6,4,1,1,0,0,6,0,4,6,2,163.33864,3
76561198383463115,535,5,3,0,0,1,1,3,2,3,5,0,289.037275,2
76561198059354772,780,8,4,1,0,3,0,8,0,5,8,5,151.87077142857146,2
76561198233625276,475,2,0,1,1,0,0,2,0,5,2,6,393.6868999999999,6
76561197991339443,201,2,2,0,0,0,0,2,0,5,2,5,698.0718999999999,3
76561198075205191,128,0,0,0,0,0,0,0,0,0,0,6,0.0,2
76561198078667617,254,3,0,0,0,3,0,1,2,5,3,5,8.501999999999953,2
76561198313701683,407,3,3,0,0,0,0,3,0,4,3,6,66.70330000000001,3
76561197978777466,1870,18,0,16,1,0,1,17,1,5,18,6,67.43312941176471,2
76561198407070089,696,5,2,3,0,0,0,3,2,4,5,5,88.6945,5
76561198349350028,152,1,0,0,1,0,0,1,0,5,1,5,0.0,1
76561198331882549,319,3,0,2,1,0,0,3,0,5,3,5,126.71499999999992,1
76561198159286505,184,1,1,0,0,0,0,1,0,5,1,6,0.0,1
76561198406817264,1062,9,5,4,0,0,0,9,0,5,9,5,78.0151375,4
76561198408790400,576,6,0,4,2,0,0,5,1,5,6,4,131.83280000000002,2
76561198363678020,639,7,6,0,1,0,0,6,1,4,7,7,199.20906666666667,1
76561198377496477,305,3,1,2,0,0,0,2,1,4,3,5,113.8673,1
76561198414224907,200,2,0,2,0,0,0,2,0,5,2,7,8.753000000000384,0
76561198357473302,370,3,0,2,1,0,0,3,0,5,3,6,470.64145,1
76561198298942849,859,6,6,0,0,0,0,6,0,5,6,10,126.30462000000003,6
76561198076391156,550,6,4,1,0,1,0,4,2,5,6,4,120.24695999999999,0
76561198138369801,519,5,2,0,1,2,0,5,0,4,5,7,240.52532499999998,2
76561198287766403,109,1,1,0,0,0,0,1,0,3,1,6,0.0,2
76561198093028103,644,6,2,2,1,1,0,4,2,4,6,3,188.1067,3
76561198326582536,1142,11,6,5,0,0,0,9,2,5,11,3,89.10215,4
76561198044028830,545,8,2,0,0,6,0,8,0,3,8,5,134.52264285714293,4
76561198152432269,381,5,4,0,0,1,0,4,1,5,5,6,142.59605,1
76561198312825571,307,2,2,0,0,0,0,1,1,4,2,3,33.94550000000004,2
76561198193078057,756,8,5,0,0,3,0,6,2,5,8,7,274.4900285714286,2
76561198066302678,935,10,7,2,0,1,0,10,0,5,10,5,231.53766666666672,2
76561198316053957,614,7,3,0,0,4,0,7,0,5,7,6,316.01865,1
76561198214303835,823,6,3,3,0,0,0,5,1,5,6,6,332.50034,5
76561198237998798,932,9,7,2,0,0,0,9,0,5,9,7,144.631625,3
76561198190866502,524,3,2,0,1,0,0,3,0,5,3,9,410.69450000000006,5
76561198317377576,673,6,6,0,0,0,0,5,1,4,6,8,338.48282,6
76561198203902724,994,10,2,4,1,3,0,7,3,5,10,6,205.1293111111111,3
76561198205653276,851,9,7,0,1,0,1,8,1,4,9,8,141.9084125,5
76561198318945653,336,3,3,0,0,0,0,3,0,4,3,9,451.34354999999994,1
76561198165582720,871,8,0,6,0,1,0,6,2,5,8,5,163.9790285714286,2
76561198293192524,281,2,2,0,0,0,0,2,0,4,2,6,671.5266999999999,4
76561198074999744,275,3,1,0,2,0,0,3,0,4,3,6,241.4139,2
76561198043593574,208,0,0,0,0,0,0,0,0,0,0,4,0.0,4
76561198359794160,82,1,0,0,0,0,0,1,0,5,1,6,0.0,1
76561198368340546,314,3,2,0,0,1,0,2,1,5,3,3,503.08225,2
76561198044028830,815,7,6,0,0,1,0,6,1,5,7,3,191.9288,3
76561198289478216,514,4,4,0,0,0,0,4,0,5,4,4,338.47236666666663,3
76561198311948141,709,8,2,6,0,0,0,7,1,3,8,2,210.4583,1
76561198236098556,381,4,2,0,2,0,0,3,1,3,4,1,491.54850000000005,1
76561198094712968,1081,9,2,4,0,3,0,6,3,5,9,7,283.4224,5
76561197991689778,949,6,6,0,0,0,0,4,2,5,6,10,398.76678000000004,7
76561198377257007,1013,12,6,2,1,3,0,9,3,5,12,8,230.8114090909091,6
76561198385509734,830,6,3,3,0,0,0,5,1,5,6,7,368.86800000000005,5
76561198277789367,1333,15,8,5,2,0,0,13,2,3,15,8,178.90718571428573,1
76561198336305130,1042,8,6,0,0,2,0,6,2,5,8,8,332.5646428571428,6
76561198044028830,928,9,6,0,0,3,0,9,0,4,9,11,313.3493375,5
76561198151630590,833,7,0,6,1,0,0,4,3,5,7,8,322.0695,6
76561198319443873,788,9,3,6,0,0,0,7,2,4,9,10,272.54564999999997,4
76561198218343300,569,6,5,1,0,0,0,6,0,5,6,10,251.9422000000001,4
76561198400323434,1216,12,3,6,3,0,0,8,4,5,12,10,142.6167181818182,4
76561198163000672,362,4,3,0,0,0,0,4,0,5,4,10,425.08500000000004,2
76561198405235738,733,6,6,0,0,0,0,6,0,4,6,6,423.58046,5
76561198281098433,856,8,8,0,0,0,0,7,1,4,8,4,117.84234285714287,4
76561198417475716,452,5,2,0,2,1,0,4,1,5,5,8,248.50962499999997,3
76561198150429153,592,6,3,3,0,0,0,4,2,5,6,7,400.57806000000005,4
76561198396743239,749,7,1,5,1,0,0,7,0,5,7,6,271.8244833333334,6
76561198119209989,556,8,6,0,2,0,0,8,0,5,8,9,250.39145714285718,5
76561198376261965,1026,9,6,2,1,0,0,8,1,5,9,7,251.3965125,5
76561198121348801,841,8,3,4,0,1,0,5,3,3,8,6,301.1510285714286,2
76561198120933819,487,1,0,0,0,0,0,1,0,4,1,7,0.0,7
76561198243204226,437,2,1,1,0,0,0,2,0,5,2,6,689.1028000000001,3
76561198032337688,433,5,3,0,1,1,0,5,0,5,5,6,349.6388,5
76561198145416099,799,9,7,0,1,0,0,9,0,5,9,6,135.0462875,5
76561198004313307,346,5,2,1,2,0,0,5,0,4,5,4,257.93305,0
76561198172418809,1212,11,11,0,0,0,0,11,0,5,11,3,142.18746000000002,2
76561198151897918,803,9,3,6,0,0,0,9,0,4,9,3,173.686275,0
76561198204678608,267,2,1,0,0,1,0,2,0,5,2,6,436.124,4
76561198091704738,420,4,3,1,0,0,0,4,0,3,4,4,311.8389333333334,3
76561198072485447,328,3,3,0,0,0,0,3,0,5,3,6,20.52150000000003,3
76561198333770768,1573,16,12,1,2,1,0,11,5,5,16,11,146.80720000000002,4
76561198160112006,447,4,1,1,2,0,0,4,0,5,4,15,191.48643333333337,3
76561198215010519,814,8,6,2,0,0,0,8,0,5,8,13,219.73448571428574,4
76561198405466550,1357,14,9,2,3,0,0,14,0,4,14,12,164.89974615384614,3
76561198394517207,1133,7,4,1,0,2,0,6,1,5,7,14,263.49285000000015,11
76561198312562049,1612,14,7,5,1,0,0,11,3,5,14,12,145.03009999999998,8
76561198409613252,1287,12,4,2,3,3,0,12,0,5,12,10,192.49208181818184,7
76561198268633502,1762,22,11,9,2,0,0,21,1,4,22,11,104.11074761904761,2
76561198292480977,1647,11,9,0,1,1,0,9,2,4,11,8,180.35086,13
76561198165854467,812,6,2,0,0,4,0,6,0,5,6,8,379.66618000000017,6
76561198075670789,906,4,4,0,0,0,0,4,0,5,4,7,409.9104333333334,7
76561198081870555,714,8,8,0,0,0,0,8,0,5,8,6,260.6921571428572,2
76561198135621884,764,7,4,2,0,1,0,7,0,5,7,4,282.5556833333333,3
76561198172373614,1042,11,4,6,1,0,0,9,2,5,11,7,105.16839999999999,3
76561198264394408,733,7,3,4,0,0,0,6,1,3,7,4,299.56745,5
76561198147137559,506,4,1,3,0,0,0,2,2,5,4,7,70.77700000000004,3
76561198252308492,784,7,6,1,0,0,0,7,0,5,7,8,302.6406666666667,6
76561198361126177,417,2,2,0,0,0,0,2,0,4,2,7,855.3861,6
76561198375223346,398,4,1,2,0,1,0,4,0,4,4,9,594.8743666666666,3
76561198314432158,1061,12,1,10,1,0,0,12,0,3,12,7,148.17188181818184,2
76561198121050731,1430,15,14,1,0,0,0,12,3,5,15,13,116.96090714285715,5
76561198137444224,1550,14,5,7,0,2,0,10,4,5,14,8,175.59384615384613,8
76561198197100411,1537,14,10,2,1,1,0,13,1,4,14,13,173.60541538461536,7
76561198081758640,1175,15,9,3,1,1,1,10,5,4,15,10,140.72282857142855,7
76561198121106691,573,3,3,0,0,0,0,3,0,5,3,12,282.09299999999996,7
76561198026984544,1414,12,7,3,0,0,0,4,8,5,12,12,187.84238181818182,7
76561197963886526,955,7,1,0,2,4,0,7,0,5,7,7,223.0177166666667,5
76561197986620235,1087,5,1,1,2,1,0,5,0,5,5,14,456.6705,11
76561198144254237,1505,16,0,13,1,1,0,13,3,4,16,13,138.90547333333333,1
76561198059357619,1167,15,11,0,1,3,0,11,4,4,15,14,133.85302142857142,3
76561198034862236,904,8,2,5,0,0,1,7,1,5,8,10,84.48064285714285,6
76561198190656759,400,2,0,0,1,1,0,2,0,5,2,10,384.5638,4
76561198357527863,592,5,2,0,2,1,0,4,1,4,5,10,261.775725,4
76561198350436144,824,7,5,0,0,2,0,6,1,4,7,9,225.5296166666667,5
76561198380696839,520,4,0,0,0,4,0,4,0,5,4,10,41.00999999999999,7
76561198300818629,1340,13,8,5,0,0,0,12,1,5,13,7,118.47455000000001,4
76561198027105421,1019,12,5,6,1,0,0,10,2,5,12,4,125.68726363636364,3
76561198342390949,1178,11,11,0,0,0,0,10,1,5,11,4,78.61001000000005,3
76561198122745084,945,11,6,2,3,0,0,9,2,5,11,5,125.97798,2
76561198298822229,510,3,3,0,0,0,0,2,1,5,3,7,83.89550000000008,6
76561198312801145,294,2,1,1,0,0,0,2,0,5,2,6,214.96899999999982,2
76561198338388691,1884,23,21,0,1,0,1,15,8,5,23,8,102.60355454545456,4
76561198297150914,2114,19,17,1,0,0,0,14,5,5,19,20,116.88796666666667,7
76561198119563432,1091,8,8,0,0,0,0,7,1,5,8,14,251.2647142857143,10
76561198357446050,2363,25,18,5,0,1,1,22,3,5,25,16,73.64110833333334,2
76561198065690476,1577,19,8,6,0,5,0,17,2,5,19,15,126.91866666666667,6
76561198282993597,1117,12,8,0,0,2,2,10,2,4,12,16,177.46612727272728,9
76561198392308995,815,7,6,0,0,1,0,6,1,4,7,17,276.4081,11
76561198301192460,1224,7,6,0,0,1,0,6,1,4,7,15,341.7655,11
76561197995044370,1703,19,12,0,0,6,0,11,8,4,19,14,114.29693333333333,12
76561198221512652,383,4,3,0,0,1,0,4,0,5,4,5,326.66269999999986,3
76561198044028830,1026,15,9,0,0,5,1,15,0,4,15,4,93.70177142857142,4
76561198382735854,755,7,5,0,0,1,0,4,3,3,7,2,210.32835,4
76561198356095148,688,9,7,1,0,1,0,9,0,4,9,4,150.45023750000004,3
76561198253770557,330,3,2,0,0,0,1,3,0,5,3,6,469.1036999999998,2
76561198292633933,659,4,4,0,0,0,0,4,0,5,4,17,348.61203333333316,6
76561197978760083,454,4,1,3,0,0,0,3,1,5,4,5,227.55699999999987,3
76561198379961128,1028,6,3,1,2,0,0,5,1,4,6,4,66.02942,7
76561198341215063,604,4,3,0,0,0,0,4,0,5,4,9,315.5734333333333,7
76561198151739395,248,3,2,1,0,0,0,2,1,5,3,3,80.96409999999997,0
76561198371393702,730,4,2,0,1,1,0,4,0,5,4,9,399.14900000000006,8
76561198059338046,1598,17,15,1,1,0,0,13,4,4,17,7,138.248475,5
76561198400235947,1246,12,8,0,0,4,0,9,3,5,12,8,202.70015454545458,7
76561198047336377,1542,11,6,1,0,4,0,10,1,5,11,11,161.42685,9
76561198365786015,667,6,4,1,0,0,1,6,0,5,6,9,261.71688,7
76561198308603283,1151,16,10,3,1,1,1,16,0,5,16,9,150.24324000000004,2
76561198261934619,978,8,6,1,1,0,0,5,3,5,8,11,277.19980000000004,7
76561198356095148,1073,7,4,3,0,0,0,6,1,5,7,9,309.6026166666667,10
76561198044028830,713,6,4,0,0,2,0,6,0,4,6,12,289.45292,9
76561198221512652,1007,8,3,2,0,2,1,7,1,5,8,10,117.7434285714286,4
76561198221512652,1604,17,0,8,1,8,0,14,3,5,17,9,105.71981250000002,4
76561198044028830,1187,13,11,0,2,0,0,13,0,5,13,11,138.83165,6
76561198216481273,559,5,2,0,0,3,0,5,0,4,5,8,273.336975,7
76561197994242158,356,4,2,0,2,0,0,4,0,3,4,11,155.85909999999998,3
76561198283988031,866,13,0,2,3,8,0,12,1,5,13,10,69.17754166666667,6
76561198359266826,1226,10,5,5,0,0,0,8,2,5,10,14,99.20358888888887,7
76561198412179637,255,2,2,0,0,0,0,2,0,4,2,4,876.5473000000001,1
76561198123914222,1368,14,5,2,2,5,0,11,3,5,14,8,112.13660769230768,4
76561198400761094,1392,12,5,3,0,3,1,8,4,4,12,10,127.72001818181819,8
76561198349417284,1231,12,2,2,3,5,0,12,0,5,12,17,70.48791818181819,4
76561198076885082,368,3,0,3,0,0,0,3,0,5,3,2,62.94870000000003,1
76561197987160954,212,1,0,1,0,0,0,1,0,5,1,2,0.0,2
76561198044028830,258,3,0,0,0,3,0,3,0,4,3,3,144.4319999999999,2
76561198221512652,471,5,3,1,0,0,1,3,2,3,5,1,77.65450000000001,1
76561198216481273,139,2,2,0,0,0,0,1,1,5,2,1,7.407500000000027,1
76561198197805239,200,2,0,2,0,0,0,2,0,5,2,3,9.15790000000004,0
76561198408002749,463,3,2,0,1,0,0,3,0,4,3,3,154.12130000000002,2
76561198415608154,100,2,1,1,0,0,0,1,1,3,2,2,255.20180000000005,1
76561198317357309,133,1,0,0,0,1,0,1,0,5,1,3,0.0,1
76561198337769190,100,1,1,0,0,0,0,1,0,5,1,3,0.0,0
76561198197410367,1151,11,5,5,0,0,1,8,3,5,11,11,160.30729000000002,10
76561198156291661,1255,11,4,4,0,2,1,11,0,5,11,8,196.02703,6
76561198124335697,1552,14,11,1,1,1,0,14,0,5,14,10,137.50126923076922,6
76561198331560196,259,2,0,0,1,1,0,1,1,5,2,10,611.9989,4
76561198120715352,751,7,7,0,0,0,0,7,0,3,7,10,320.91360000000003,3
76561198350135332,1436,13,11,2,0,0,0,13,0,5,13,10,153.19495,5
76561198328578941,1157,11,3,6,1,1,0,10,1,5,11,8,202.16571000000005,4
76561198267582886,1204,14,12,0,2,0,0,13,1,4,14,7,130.5935846153846,3
76561198363684966,1045,10,7,1,1,1,0,10,0,4,10,8,223.83332222222222,4
76561198384945632,364,1,1,0,0,0,0,1,0,5,1,12,0.0,6
76561198132703484,504,3,3,0,0,0,0,3,0,5,3,8,260.225,7
76561198403771104,1386,14,3,9,2,0,0,12,2,4,14,9,178.36955384615385,3
76561198143510330,796,6,6,0,0,0,0,5,1,5,6,11,260.6499999999999,7
76561198093789290,207,1,1,0,0,0,0,1,0,3,1,12,0.0,5
76561198415062589,1025,11,0,10,1,0,0,8,3,5,11,6,193.50925999999998,2
76561198416992177,1311,11,3,6,2,0,0,8,3,5,11,6,232.22109999999998,4
76561198416741283,1393,13,8,4,1,0,0,11,2,5,13,9,181.07826666666668,5
76561198398311238,1297,13,2,5,5,1,0,11,2,4,13,8,147.85470833333332,1
76561197983265467,942,9,8,1,0,0,0,8,1,3,9,8,290.1591375,1
76561198205871509,40,1,0,0,1,0,0,1,0,5,1,5,0.0,2
76561198359172139,840,8,8,0,0,0,0,7,1,5,8,9,293.8218285714286,5
76561198371751036,1447,16,5,6,4,1,0,16,0,5,16,7,136.59131333333332,3
76561198186361523,1316,11,9,0,0,2,0,9,2,4,11,8,207.88057000000003,6
76561198415279525,1209,10,8,0,0,2,0,10,0,3,10,7,124.07093333333331,8
76561197977407379,707,7,7,0,0,0,0,7,0,5,7,8,171.44043333333335,3
76561198272609513,1085,10,5,0,3,2,0,10,0,5,10,11,165.55766666666665,5
76561198105501765,842,9,2,6,0,1,0,8,1,4,9,9,257.18005000000005,4
76561198116430286,931,6,5,0,0,0,0,6,0,3,6,11,405.35065999999995,7
76561198340883655,884,6,2,0,0,0,0,6,0,5,6,11,249.09132,5
76561198342446296,860,8,2,4,2,0,0,7,1,5,8,10,232.67020000000002,2
76561198360085352,1106,10,10,0,0,0,0,10,0,5,10,14,217.77322222222222,10
76561198162963632,1038,10,6,2,2,0,0,10,0,4,10,12,250.61074444444446,8
76561198301341705,1320,15,15,0,0,0,0,11,4,3,15,9,163.5137142857143,6
76561198253431077,1786,11,5,4,0,2,0,11,0,3,11,15,234.75812000000005,11
76561198123786063,945,7,7,0,0,0,0,6,1,5,7,13,222.70316666666668,10
76561198088900139,2040,18,16,2,0,0,0,17,1,5,18,10,138.97004705882352,9
76561198151251227,955,8,7,0,0,1,0,8,0,4,8,13,336.5431285714286,6
76561198190781675,1681,15,10,4,1,0,0,14,1,5,15,11,159.2694642857143,6
76561198169757169,1041,8,6,0,0,2,0,8,0,5,8,10,307.52285714285716,8
76561198320372378,959,12,10,2,0,0,0,11,1,2,12,7,212.70321818181822,1
76561198125742764,661,3,3,0,0,0,0,3,0,5,3,6,644.6483999999999,6
76561198268748349,1186,12,10,1,0,0,1,11,1,4,12,4,135.30772727272728,3
76561197971324920,457,6,0,1,0,5,0,4,2,3,6,5,271.62358,3
76561198059443350,865,9,5,3,1,0,0,8,1,5,9,6,180.7661875,1
76561198412478614,539,5,4,1,0,0,0,3,2,5,5,4,164.2015,4
76561198275353202,644,5,2,2,0,1,0,5,0,5,5,7,357.36785,4
76561198171006665,450,5,4,0,0,1,0,3,2,4,5,7,381.847725,2
76561198289694880,296,1,1,0,0,0,0,1,0,5,1,7,0.0,4
76561198398201844,522,4,3,1,0,0,0,4,0,3,4,7,22.69053333333333,4
76561198324402118,966,10,7,1,1,0,1,9,1,5,10,7,135.5318666666667,4
76561198252966784,1258,13,5,8,0,0,0,9,4,4,13,12,200.11380833333337,4
76561198413850027,726,12,9,1,1,1,0,10,2,5,12,10,213.71687272727274,0
76561198018899613,859,5,3,0,0,2,0,3,2,4,5,9,534.021525,8
76561198268750696,1397,8,7,1,0,0,0,4,4,4,8,11,292.8353,12
76561198121905215,1466,14,13,0,0,1,0,11,3,5,14,11,141.18396923076924,7
76561198415279525,1158,10,8,2,0,0,0,9,1,5,10,10,247.70287777777781,6
76561198371751036,1138,10,3,5,1,0,0,8,2,5,10,12,267.5963555555556,5
76561197977407379,1400,15,15,0,0,0,0,8,7,4,15,10,166.25035,6
76561198186361523,1366,12,12,0,0,0,0,8,4,5,12,11,199.6738090909091,10
76561198359172139,754,6,6,0,0,0,0,6,0,5,6,9,379.34978,3
76561198004222916,991,10,4,5,0,1,0,10,0,3,10,6,201.4787,3
76561198326987779,667,7,5,1,1,0,0,7,0,5,7,6,323.63161666666673,4
76561198239499888,1143,12,10,0,1,1,0,12,0,5,12,4,186.2029363636364,4
76561198072064806,630,5,1,0,2,2,0,5,0,4,5,7,510.729575,3
76561198274473529,999,12,10,0,0,1,1,12,0,5,12,7,121.87131818181818,4
76561197983391733,680,5,4,0,0,1,0,5,0,4,5,11,409.94515,7
76561197983678954,440,3,1,2,0,0,0,3,0,3,3,9,235.7839,6
76561198101329441,882,8,4,2,0,1,1,7,1,5,8,13,253.96202857142856,3
76561198058272473,1336,13,1,7,2,3,0,13,0,5,13,7,156.52754166666665,6
76561198191607029,135,1,1,0,0,0,0,1,0,5,1,6,0.0,2
76561198286899669,1832,18,12,3,0,3,0,16,2,4,18,10,130.59086470588235,5
76561198159850760,600,6,4,1,1,0,0,6,0,5,6,12,344.01432000000005,2
76561198016286092,773,6,4,1,0,1,0,4,2,5,6,12,416.3865400000001,8
76561198130027485,994,9,7,0,0,2,0,7,2,4,9,10,326.3714125,4
76561198035317105,997,9,1,6,0,0,0,8,1,3,9,10,320.394025,3
76561198217746515,1491,13,3,10,0,0,0,13,0,5,13,12,179.95877499999997,7
76561198135621884,802,10,9,0,0,0,1,6,4,5,10,8,267.7022,9
76561198075670789,1544,16,16,0,0,0,0,11,5,5,16,10,109.13326666666669,5
76561198038915944,1256,10,6,4,0,0,0,10,0,5,10,8,200.24178888888898,7
76561198000191095,636,5,3,2,0,0,0,4,1,5,5,10,290.79644999999994,4
76561198160348332,1732,17,7,6,1,2,0,14,3,4,17,14,128.46603125000001,8
76561198090997734,1312,13,11,0,2,0,0,13,0,4,13,16,192.09145833333332,6
76561198080182295,1188,10,7,2,0,1,0,8,2,5,10,12,180.20466666666667,9
76561198268822242,1009,9,8,0,0,1,0,8,1,5,9,13,230.54807499999995,6
76561198239111560,1326,10,4,4,0,2,0,7,3,4,10,12,211.89472222222219,9
76561197977792763,1871,20,16,0,1,3,0,16,4,5,20,11,130.52169473684208,4
76561198070996787,1075,11,6,1,1,3,0,6,5,4,11,11,231.99759,7
76561198265845129,1553,11,8,0,0,3,0,10,1,5,11,13,241.49001999999996,10
76561197971000603,1753,19,16,0,0,3,0,15,4,5,19,11,112.46251666666666,8
76561198302775095,659,5,4,0,0,1,0,2,3,5,5,12,528.398025,6
76561198079869834,1225,11,11,0,0,0,0,11,0,5,11,10,100.94749000000002,7
76561198189193206,781,6,4,2,0,0,0,4,2,4,6,10,252.72084,8
76561198206365868,1126,10,10,0,0,0,0,9,1,4,10,10,183.44167777777778,6
76561198173983293,685,7,2,5,0,0,0,6,1,5,7,7,171.12934999999996,5
76561198278363192,1098,12,5,3,1,3,0,11,1,3,12,6,147.41524545454547,5
76561198200200962,971,9,8,0,1,0,0,5,4,5,9,9,208.96473749999998,4
76561198137945589,1366,13,12,0,1,0,0,12,1,5,13,9,138.631925,5
76561198359172139,546,5,5,0,0,0,0,5,0,5,5,9,186.67020000000002,4
76561197977407379,787,6,6,0,0,0,0,5,1,3,6,9,314.41495999999995,7
76561198068369287,986,10,8,0,1,1,0,10,0,4,10,10,175.61003333333332,4
76561197988991928,895,10,4,0,1,4,0,10,0,5,10,5,162.06837777777778,2
76561198087782985,276,1,1,0,0,0,0,0,1,5,1,6,0.0,4
76561198338231709,334,3,3,0,0,0,0,3,0,4,3,6,721.2439999999999,3
76561197969761850,396,3,1,1,0,1,0,2,1,5,3,6,144.35195,3
76561198042050099,984,9,6,3,0,0,0,8,1,5,9,4,155.35768750000003,3
76561198058541187,854,5,5,0,0,0,0,4,1,4,5,5,318.005675,6
76561197996212870,935,10,6,3,0,0,1,9,1,5,10,4,161.65172222222225,2
76561198042482453,569,5,5,0,0,0,0,5,0,4,5,5,367.21685,1
76561198203235207,345,4,4,0,0,0,0,3,1,5,4,5,86.46219999999998,2
76561198315329076,247,3,1,0,1,1,0,3,0,5,3,7,553.5131500000001,2
76561198082583849,873,9,9,0,0,0,0,9,0,5,9,10,178.7704375,7
76561198095956492,1253,10,9,1,0,0,0,8,2,5,10,10,186.80121111111112,10
76561198122042208,2342,21,20,0,0,1,0,15,6,4,21,6,87.428785,6
76561198044637170,1023,11,10,0,0,0,1,10,1,4,11,9,175.53276,5
76561198170940334,922,9,5,0,1,3,0,8,1,5,9,10,198.331275,3
76561198271709459,1595,12,9,3,0,0,0,11,1,5,12,14,156.8215727272728,12
76561198021203476,1420,14,10,3,0,1,0,12,2,5,14,12,112.23925384615384,4
76561198067231440,1073,10,10,0,0,0,0,6,4,4,10,11,142.8187222222222,4
76561198195968269,896,9,9,0,0,0,0,8,1,5,9,10,191.2977875,4
76561197987782371,407,0,0,0,0,0,0,0,0,0,0,13,0.0,11
76561198016864744,1300,10,5,4,1,0,0,10,0,5,10,12,327.93726666666674,9
76561198073874373,1217,10,10,0,0,0,0,8,2,5,10,14,303.28773333333334,7
76561198361366049,901,9,5,4,0,0,0,8,1,4,9,11,360.57665,5
76561198138611552,1033,7,6,0,1,0,0,5,2,5,7,11,395.6521666666667,8
76561197999838566,1773,19,9,0,0,10,0,16,3,4,19,9,129.57119444444444,6
76561198141354379,1134,10,6,4,0,0,0,8,2,5,10,12,314.71659999999997,10
76561198302775095,905,10,6,0,0,4,0,7,3,4,10,11,313.54623333333336,5
76561197971000603,1695,17,16,0,0,1,0,15,2,5,17,10,140.90358125,6
76561198070996787,1093,8,6,0,0,2,0,6,2,3,8,11,410.0292428571429,10
76561198265845129,1377,12,9,0,0,2,1,11,1,4,12,11,246.1669636363636,12
76561198032527478,555,4,0,1,2,0,1,3,1,5,4,10,558.7178666666667,5
76561198273453728,953,10,2,1,0,7,0,10,0,5,10,7,221.9568111111111,2
76561198029564967,966,8,6,0,0,2,0,4,4,4,8,7,237.52137142857143,6
76561198017697212,842,9,8,0,0,1,0,7,2,5,9,6,217.259425,3
76561198073890183,835,7,0,4,2,0,1,7,0,4,7,7,280.3539,5
76561198401280695,605,4,0,4,0,0,0,3,1,5,4,8,240.8018666666668,6
76561197961413225,713,8,6,0,0,1,1,3,5,5,8,7,188.98649999999998,5
76561198136648505,890,9,1,1,1,6,0,8,1,5,9,8,215.79819999999998,5
76561198156530742,756,4,0,0,4,0,0,4,0,4,4,7,342.01590000000004,5
76561198301527655,1095,12,3,7,2,0,0,10,2,4,12,8,152.67306363636362,1
76561198084666337,1238,13,3,10,0,0,0,10,3,5,13,7,200.44252500000002,4
76561198000045992,1053,9,7,2,0,0,0,8,1,5,9,9,237.64465,7
76561198301303700,600,6,3,1,0,2,0,5,1,4,6,6,324.70256,3
76561198147951352,1174,8,8,0,0,0,0,7,1,5,8,7,306.78777142857143,8
76561198219685147,764,8,8,0,0,0,0,7,1,4,8,7,267.24487142857146,5
76561198240123386,569,5,5,0,0,0,0,5,0,4,5,9,484.39240000000007,4
76561198211078143,699,5,5,0,0,0,0,4,1,5,5,10,497.76195,7
76561198000570708,961,10,10,0,0,0,0,5,5,3,10,7,188.27022222222223,5
76561198008711599,876,9,2,6,0,0,0,6,3,3,9,9,212.280675,2
76561198193863762,719,7,7,0,0,0,0,7,0,5,7,9,314.68201666666664,5
76561198262650571,454,4,1,3,0,0,0,4,0,3,4,1,301.98983333333337,2
76561198750205964,571,6,3,3,0,0,0,6,0,5,6,2,162.6087,3
76561198416992177,375,5,0,3,0,1,1,5,0,5,5,1,192.711725,0
76561198370360119,515,5,2,3,0,0,0,5,0,5,5,2,234.361,1
76561198369295079,79,0,0,0,0,0,0,0,0,0,0,2,0.0,1
76561198396784641,200,2,1,1,0,0,0,2,0,4,2,4,60.01239999999996,0
76561198357575520,406,4,2,2,0,0,0,4,0,4,4,4,298.7078666666667,1
76561198310316475,123,1,1,0,0,0,0,1,0,5,1,4,0.0,1
76561198380672865,64,0,0,0,0,0,0,0,0,0,0,4,0.0,1
76561198389424116,80,1,1,0,0,0,0,1,0,5,1,4,0.0,1
76561198297407639,595,9,3,6,0,0,0,8,1,3,9,8,188.24313750000002,3
76561198070717206,1637,11,6,0,0,5,0,7,4,4,11,8,206.30946000000003,11
76561198164665263,936,10,8,0,1,1,0,8,2,4,10,6,175.1066666666667,5
76561198202055749,935,8,3,5,0,0,0,8,0,5,8,8,302.14908571428566,6
76561198185682374,1043,9,8,0,0,1,0,8,1,5,9,7,214.713525,7
76561198090986369,807,5,2,0,2,1,0,5,0,5,5,9,364.475775,9
76561198120608864,503,5,2,1,0,2,0,5,0,5,5,11,511.56195,1
76561197985776228,1232,12,8,3,1,0,0,9,3,3,12,7,180.3252272727273,6
76561198081374059,713,8,8,0,0,0,0,7,1,4,8,9,290.7849857142857,8
76561198292150172,692,6,1,5,0,0,0,5,1,5,6,10,270.5513000000002,4
76561198286193990,717,6,1,0,1,3,0,5,1,5,6,9,339.98112000000003,5
76561198200701666,1241,16,14,2,0,0,0,14,2,4,16,6,97.28063333333334,4
76561197968214833,1113,10,3,3,0,4,0,10,0,4,10,10,185.79104444444445,8
76561197977407379,1041,9,8,0,0,1,0,9,0,3,9,7,208.6320375,5
76561198017997310,862,7,6,0,0,1,0,7,0,5,7,11,230.50153333333336,3
76561198248500022,2193,21,1,14,2,4,0,19,2,5,21,7,83.80915,7
76561198346332860,771,7,7,0,0,0,0,6,1,3,7,11,183.25424999999998,4
76561198268164625,382,3,1,0,0,2,0,2,1,4,3,9,333.83635000000004,4
76561198089623293,840,6,6,0,0,0,0,3,3,5,6,10,252.26657999999998,6
76561198139332555,609,6,5,0,1,0,0,6,0,5,6,11,275.29553999999996,5
76561198292691691,1384,11,1,6,0,4,0,7,4,5,11,10,144.65254,7
76561198248818020,588,4,2,0,0,2,0,4,0,5,4,11,780.6039,8
76561198291862416,908,9,5,0,2,0,2,8,1,4,9,11,278.0225125,6
76561198136523854,732,9,5,4,0,0,0,7,2,3,9,10,208.7387125,1
76561198206812669,1036,10,10,0,0,0,0,7,3,5,10,8,219.80293333333336,5
76561198212955268,1093,11,11,0,0,0,0,9,2,5,11,11,143.05823000000004,5
76561198101901836,649,6,6,0,0,0,0,4,2,5,6,8,400.54697999999996,6
76561198321303705,1164,10,3,5,0,2,0,9,1,4,10,8,259.5935111111111,7
76561198315181659,1478,16,7,7,0,1,1,13,3,3,16,7,158.30273333333332,6
76561198154335740,872,7,6,1,0,0,0,7,0,5,7,9,163.7971666666667,7
76561198407451122,456,3,0,2,1,0,0,2,1,4,3,5,671.95815,4
76561198316370253,855,7,7,0,0,0,0,7,0,5,7,5,248.91683333333333,5
76561198370855479,588,5,2,2,0,1,0,5,0,5,5,7,417.156625,3
76561198283082362,714,9,8,0,0,1,0,7,2,5,9,3,192.98287499999998,3
76561198416992177,353,5,5,0,0,0,0,5,0,3,5,3,179.86885,2
76561198175991531,1018,8,8,0,0,0,0,5,3,5,8,6,219.54250000000002,5
76561198105069062,525,6,6,0,0,0,0,5,1,5,6,6,211.51286,3
76561198198215151,437,3,2,1,0,0,0,3,0,4,3,7,442.50175,4
76561198175211887,569,5,5,0,0,0,0,4,1,4,5,5,331.68852499999997,2
76561198099878783,145,1,0,1,0,0,0,1,0,5,1,5,0.0,2
76561198343130077,661,8,2,0,5,0,0,8,0,5,8,5,233.16109999999998,1
76561198242313408,1397,15,9,0,1,5,0,11,4,3,15,1,87.441,3
76561198109715140,265,3,0,0,0,0,0,2,1,4,3,4,506.34765,0
76561198377529615,515,3,1,0,1,0,0,2,1,4,3,5,630.137,4
76561198297934710,508,4,1,1,2,0,0,3,1,5,4,6,357.4230333333333,3
76561198098393699,546,4,3,0,0,1,0,3,1,5,4,7,471.83060000000006,3
76561198081870555,678,5,0,2,0,2,0,4,1,3,5,7,307.04369999999994,4
76561198135621884,539,5,3,0,0,2,0,5,0,4,5,6,274.07629999999995,4
76561198292385782,672,4,2,2,0,0,0,4,0,5,4,7,264.9468,5
76561198308665175,414,4,1,0,1,2,0,3,1,4,4,7,422.24830000000003,2
76561198008807344,1075,11,11,0,0,0,0,9,2,5,11,5,134.87053000000006,4
76561198400187746,617,3,2,0,0,1,0,2,1,5,3,9,534.8091999999999,7
76561198414284873,740,9,4,1,4,0,0,8,1,4,9,2,157.2814875,4
76561198416992177,764,6,2,3,0,1,0,5,1,5,6,7,255.54125999999997,5
76561198414285442,962,10,0,10,0,0,0,9,1,5,10,4,114.1306111111111,1
76561197971565673,708,5,3,0,0,0,2,4,1,5,5,8,323.04679999999996,4
76561198119623474,625,4,3,1,0,0,0,3,1,5,4,8,302.0026,4
76561198018237424,501,4,4,0,0,0,0,4,0,4,4,8,247.6947666666667,3
76561198213728832,1157,13,11,0,0,0,1,12,1,4,13,7,112.68404166666666,3
76561197963721329,137,1,1,0,0,0,0,1,0,5,1,8,0.0,2
76561198064765958,1374,16,11,0,0,5,0,11,5,4,16,7,138.06105999999997,8
76561198180870978,919,14,9,1,4,0,0,14,0,5,14,8,132.48346153846154,4
76561198239249868,1337,18,15,2,0,1,0,14,4,5,18,7,105.99430000000001,6
76561198086711287,756,11,9,0,1,1,0,7,4,3,11,10,201.52605999999997,6
76561198179963995,484,5,4,0,1,0,0,5,0,3,5,12,439.61249999999995,3
76561198166262334,1598,16,14,0,0,2,0,15,1,4,16,10,125.89981333333334,7
76561198365314599,177,0,0,0,0,0,0,0,0,0,0,4,0.0,3
76561197976235739,955,10,5,1,2,2,0,10,0,5,10,12,202.99926666666664,4
76561198193491727,976,8,6,0,0,0,0,7,1,5,8,24,253.72762857142857,9
76561198220130265,1239,11,2,5,2,0,1,10,1,5,11,15,146.26579,7
76561198122897883,1227,12,8,2,0,2,0,12,0,5,12,5,128.50212727272728,5
76561198127673051,555,5,5,0,0,0,0,5,0,5,5,8,238.783275,2
76561198043138030,584,5,1,3,1,0,0,4,1,5,5,6,282.775175,4
76561198149521716,560,6,3,0,1,1,0,3,3,4,6,5,219.91274000000004,2
76561198156345590,441,3,1,0,1,1,0,2,1,5,3,7,199.56549999999993,2
76561198261613624,315,4,2,0,2,0,0,4,0,5,4,7,260.8782333333332,2
76561198044957108,485,1,1,0,0,0,0,1,0,5,1,8,0.0,6
76561197984822962,1063,11,6,3,0,1,0,10,1,4,11,7,139.7209,4
76561198326278023,623,6,5,0,1,0,0,5,1,5,6,4,231.06461999999996,3
76561198072791531,746,9,1,8,0,0,0,8,1,5,9,5,128.81503750000005,3
76561198103892100,524,6,5,0,0,0,0,4,2,5,6,7,378.08718,2
76561198281024813,645,8,2,3,0,0,0,8,0,5,8,5,210.3994285714286,3
76561198175248793,1158,11,9,1,1,0,0,10,1,3,11,5,216.54002000000006,3
76561198150728915,822,7,2,3,2,0,0,6,1,3,7,5,369.1687666666667,3
76561198212923144,1096,10,3,6,0,0,1,8,2,5,10,6,240.4053666666667,5
76561198254466364,243,3,3,0,0,0,0,3,0,4,3,9,1094.9626000000003,2
76561198199575802,685,7,6,0,0,1,0,7,0,5,7,9,233.87633333333338,3
76561198171824265,979,10,5,4,1,0,0,8,2,5,10,7,149.4631,1
76561198024211444,766,5,0,2,0,2,1,4,1,4,5,9,542.1868,7
76561198031429023,672,4,4,0,0,0,0,4,0,4,4,9,674.6066666666666,6
76561198340100471,1342,13,8,4,1,0,0,13,0,4,13,7,181.87925833333335,3
76561198388688175,1462,17,4,12,0,1,0,16,1,5,17,6,137.30413750000002,2
76561198142817160,739,5,4,0,1,0,0,5,0,5,5,8,346.88097500000003,7
76561198153230532,416,2,2,0,0,0,0,2,0,5,2,8,1214.3722,4
76561198385506354,673,6,2,4,0,0,0,5,1,4,6,7,245.81248,3
76561198062163458,737,6,3,2,1,0,0,3,3,5,6,8,318.4297600000001,4
76561198353829776,1617,18,12,6,0,0,0,16,2,5,18,5,129.96646470588234,0
76561198069590292,371,4,4,0,0,0,0,3,1,5,4,10,571.3058666666667,2
76561198123503650,438,4,3,1,0,0,0,4,0,4,4,10,725.5479999999999,4
76561198143843050,609,4,3,1,0,0,0,4,0,5,4,10,402.3736666666666,3
76561198196858054,701,6,3,3,0,0,0,6,0,5,6,7,444.49539999999996,6
76561198352070388,1146,8,5,0,0,3,0,6,2,5,8,11,282.7344571428572,11
76561197993509290,861,9,1,0,0,8,0,7,2,5,9,5,280.72517500000004,5
76561198413959241,1422,14,9,3,0,2,0,10,4,4,14,8,107.2055153846154,5
76561198197325339,877,9,6,0,0,3,0,8,1,4,9,7,235.5041375,8
76561198132636453,1074,12,4,8,0,0,0,10,2,4,12,11,198.78900000000002,3
76561198307600466,478,4,1,0,1,2,0,4,0,5,4,10,386.88433333333336,4
76561198023317027,1203,8,6,0,1,1,0,5,3,5,8,9,232.19671428571428,10
76561198094744430,593,7,3,4,0,0,0,5,2,4,7,9,262.22535,1
76561198164653626,630,7,5,0,1,1,0,6,1,5,7,7,241.19433333333333,3
76561198387537240,100,1,1,0,0,0,0,1,0,5,1,2,0.0,0
76561198166688064,523,4,2,0,0,2,0,2,2,4,4,4,77.44133333333332,3
76561198312189530,336,4,0,3,0,1,0,2,2,4,4,2,86.46383333333334,0
76561198215244759,228,1,1,0,0,0,0,1,0,3,1,4,0.0,2
76561198280017430,183,1,0,1,0,0,0,1,0,5,1,4,0.0,3
76561198307600466,165,1,0,0,0,0,0,0,1,5,1,2,0.0,2
76561198094744430,716,9,0,9,0,0,0,7,2,5,9,1,53.748175,0
76561198023317027,107,0,0,0,0,0,0,0,0,0,0,3,0.0,2
76561198095565940,126,1,1,0,0,0,0,1,0,5,1,3,0.0,1
76561198044708437,479,5,0,1,1,3,0,2,3,5,5,2,41.882700000000014,1
76561198031818822,15,0,0,0,0,0,0,0,0,0,0,1,0.0,1
76561198189346195,940,7,6,0,0,0,0,5,2,5,7,26,281.4237,9
76561198050004859,1233,10,9,0,0,1,0,10,0,5,10,8,186.17102222222223,9
76561198185441281,1601,15,6,5,2,2,0,10,5,5,15,14,127.48012142857144,6
76561198044637170,1029,11,8,1,2,0,0,8,3,5,11,17,184.27047000000002,7
76561198129584162,978,10,8,2,0,0,0,10,0,5,10,9,222.4438,5
76561198110470906,743,9,8,1,0,0,0,7,2,4,9,8,212.34545,7
76561197969301912,1067,13,12,1,0,0,0,5,8,4,13,9,150.69866666666667,6
76561198150288353,707,15,12,3,0,0,0,10,5,4,15,10,126.5982642857143,2
76561198145794457,887,19,10,0,0,0,9,16,3,5,19,7,95.96643888888889,1
76561198317309842,1385,12,0,0,0,0,0,11,1,5,12,10,171.13281818181815,4
76561198331972379,637,7,3,4,0,0,0,6,1,5,7,8,261.06120000000004,5
76561198258313865,789,9,4,3,0,0,2,5,4,5,9,10,211.6506000000001,7
76561198036205927,712,5,0,2,0,2,0,4,1,4,5,8,543.0432,5
76561198271549753,1153,9,5,1,1,2,0,9,0,5,9,10,195.59665,7
76561197985482530,1914,20,17,2,0,0,1,16,4,5,20,5,118.20232105263158,7
76561198068386120,864,8,0,8,0,0,0,6,2,4,8,8,243.8422,3
76561198352272721,743,7,4,2,0,1,0,5,2,3,7,9,261.04051666666663,5
76561198252615490,782,7,3,2,1,0,1,5,2,4,7,8,277.88741666666664,8
76561198156635616,307,1,1,0,0,0,0,1,0,5,1,9,0.0,3
76561197979649899,553,6,1,2,0,3,0,6,0,5,6,4,369.44006,2
76561198051489870,586,6,2,2,0,2,0,6,0,5,6,6,241.58528,2
76561198150621450,501,3,1,0,0,1,1,2,1,5,3,5,328.4405000000004,4
76561198040282124,1054,11,1,10,0,0,0,10,1,3,11,3,177.03874000000002,3
76561198037878956,921,7,4,2,0,0,0,6,1,4,7,5,220.93613333333334,4
76561198000527039,482,4,1,2,0,1,0,4,0,5,4,7,565.6404000000001,3
76561198318920935,369,3,2,1,0,0,0,2,1,4,3,6,426.03624999999994,2
76561198060379549,672,6,4,2,0,0,0,3,3,5,6,7,354.61534,4
76561198355550829,524,7,4,0,0,2,0,4,3,4,7,6,304.6296,3
76561198137762070,480,3,3,0,0,0,0,2,1,4,3,7,367.05055000000004,3
76561198395549849,497,3,0,3,0,0,0,3,0,5,3,6,146.26225,4
76561198141187282,342,4,2,1,1,0,0,3,1,4,4,8,286.09666666666664,3
76561198083829820,679,3,0,0,1,2,0,2,1,5,3,7,314.65115000000003,8
76561198124613117,298,3,3,0,0,0,0,3,0,5,3,7,333.62155000000007,2
76561198128475401,730,7,2,2,3,0,0,4,3,4,7,4,144.57451666666668,3
76561198138946833,867,6,3,1,2,0,0,4,2,5,6,6,200.05422000000002,4
76561198386608022,417,7,1,2,1,3,0,4,3,5,7,4,185.8644666666667,1
76561198381375256,677,6,3,3,0,0,0,3,3,4,6,3,226.44384,2
76561198143604703,819,8,0,8,0,0,0,6,2,4,8,2,87.81088571428572,1
76561198376056026,579,5,5,0,0,0,0,5,0,5,5,5,212.2832249999999,2
76561198101890753,815,6,6,0,0,0,0,6,0,5,6,12,415.4873599999999,6
76561198167900723,1822,17,9,6,2,0,0,15,2,4,17,10,142.81853125,7
76561198045995334,858,10,9,1,0,0,0,6,4,5,10,9,185.88143333333335,4
76561198136563556,856,7,7,0,0,0,0,7,0,5,7,11,220.3541,7
76561198076686755,773,7,6,1,0,0,0,5,2,4,7,10,336.3942,4
76561198057137143,520,4,2,2,0,0,0,4,0,5,4,9,809.0297333333334,4
76561198105663474,1621,16,9,7,0,0,0,15,1,5,16,11,162.57477333333333,5
76561198202560516,1474,13,13,0,0,0,0,10,3,5,13,9,155.83826666666664,9
76561198104168971,1185,11,10,1,0,0,0,8,3,4,11,9,241.17423,9
76561198062500286,921,8,8,0,0,0,0,7,1,3,8,9,320.19582857142854,8
76561198124099812,2000,18,0,9,4,3,1,14,4,5,18,9,132.87755294117648,9
76561198257330680,1108,9,6,0,0,3,0,7,2,5,9,12,163.2747500000001,15
76561198274053366,923,13,5,0,2,6,0,11,2,4,13,10,168.79146666666665,7
76561198156822325,964,4,2,0,0,2,0,4,0,5,4,11,297.2259,16
76561198004901968,1256,12,5,0,3,4,0,12,0,4,12,12,196.07597272727273,8
76561198353264490,1516,12,1,4,7,0,0,9,3,5,12,11,183.73834545454545,10
76561198394130213,1066,11,6,4,1,0,0,8,3,5,11,12,172.69689,5
76561198119836060,742,5,3,2,0,0,0,5,0,5,5,13,208.27585000000002,8
76561198360306054,1456,10,3,3,0,4,0,9,1,3,10,12,236.18252222222222,9
76561198120107697,1456,16,8,0,0,8,0,12,4,5,16,8,121.84508666666666,7
76561198119099678,1351,9,7,2,0,0,0,6,3,5,9,9,156.23407500000002,10
76561198332486996,1060,13,6,4,1,0,0,11,2,5,13,10,197.25870833333337,3
76561198066255088,579,5,4,0,1,0,0,5,0,5,5,10,582.2828000000002,3
76561198285918577,990,8,5,1,0,2,0,8,0,4,8,11,315.0700000000001,8
76561198377204426,1593,16,8,4,2,1,0,13,3,5,16,6,150.67273333333333,7
76561198198509831,505,4,4,0,0,0,0,4,0,3,4,12,375.9004333333334,6
76561198078519731,1374,15,8,6,1,0,0,12,3,4,15,8,160.73635,4
76561198173949450,1457,10,5,4,0,1,0,8,2,4,10,9,260.66411111111114,9
76561197994694427,1209,11,10,1,0,0,0,10,1,5,11,11,217.52993999999998,7
76561198065975808,539,6,6,0,0,0,0,3,3,5,6,11,415.60746,1
76561198063210882,1604,15,12,0,0,2,1,14,1,4,15,10,147.39911428571432,6
76561198285100111,455,5,4,0,0,1,0,5,0,5,5,11,534.024225,4
76561198308758711,1505,12,10,1,0,1,0,12,0,5,12,10,192.30119090909093,10
76561198162010073,1133,10,6,3,1,0,0,9,1,4,10,8,252.76977777777782,14
76561198296746535,1103,12,5,3,2,2,0,8,4,5,12,9,166.54770909090908,5
76561198123557538,1054,8,2,2,1,1,1,7,1,4,8,12,327.10601428571425,7
76561197970958584,1409,15,12,0,1,2,0,14,1,5,15,10,165.82121428571423,3
76561198233546728,871,6,1,1,1,2,1,5,1,5,6,12,420.7685800000001,4
76561198020988313,418,5,5,0,0,0,0,5,0,4,5,10,367.588025,7
76561197992824934,1251,13,6,1,1,4,1,12,1,5,13,9,166.51177500000003,5
76561198274723941,1048,17,2,0,2,13,0,16,1,5,17,9,95.6008875,8
76561198330847194,342,1,0,0,0,1,0,1,0,5,1,8,0.0,7
76561198338230170,678,6,6,0,0,0,0,5,1,4,6,7,336.60192,4
76561198325163606,550,8,4,2,2,0,0,8,0,5,8,8,140.0655142857143,2
76561198288401280,1235,14,11,3,0,0,0,13,1,5,14,7,106.94256923076924,4
76561198298992290,895,9,8,0,0,0,0,9,0,5,9,10,104.42217500000001,3
76561198282936864,1586,16,11,4,0,1,0,13,3,5,16,8,89.69303333333333,3
76561198145592510,67,0,0,0,0,0,0,0,0,0,0,3,0.0,2
76561198198806807,674,5,5,0,0,0,0,4,1,4,5,7,343.17132500000014,6
76561198327977398,1063,9,5,2,0,1,1,9,0,5,9,18,200.5837625,5
76561198004222916,1266,16,10,2,3,0,1,12,4,5,16,7,169.8314,7
76561198136706246,1197,9,2,6,1,0,0,6,3,5,9,10,147.1222875,10
76561198293569800,1000,8,8,0,0,0,0,7,1,5,8,9,180.32411428571433,8
76561198118107192,750,4,3,0,1,0,0,2,2,4,4,12,451.8978,11
76561198210251876,1001,10,6,3,1,0,0,10,0,5,10,11,231.11485555555555,4
76561198238722588,1157,7,6,0,0,1,0,7,0,5,7,11,301.7955,11
76561198258187135,829,9,2,1,1,5,0,8,1,5,9,11,300.34568750000005,5
76561198166466886,1079,10,7,0,1,2,0,8,2,4,10,10,284.1334777777777,6
76561198143951383,1246,14,3,6,4,1,0,9,5,3,14,7,194.95569230769232,5
76561198104861450,1027,9,4,4,1,0,0,7,2,5,9,8,166.0905,5
76561198038121813,1790,19,4,5,5,5,0,14,5,4,19,7,92.55985,4
76561197999718736,630,8,2,2,3,1,0,7,1,5,8,6,239.8821142857143,5
76561198359172139,767,7,5,2,0,0,0,6,1,5,7,6,256.63741666666664,4
76561197977407379,391,3,3,0,0,0,0,2,1,5,3,6,594.2394,4
76561198282026470,817,8,4,1,0,3,0,6,2,5,8,7,178.12872857142858,3
76561198141918358,876,4,2,2,0,0,0,4,0,5,4,14,261.22719999999987,5
76561198354552315,579,5,3,2,0,0,0,4,1,5,5,4,162.08302500000002,3
76561198252187286,688,5,2,1,0,2,0,4,1,4,5,10,414.097,3
76561198152524299,897,12,4,1,1,5,1,8,4,3,12,7,145.36049999999997,3
76561198163015235,510,7,5,1,0,1,0,6,1,5,7,11,205.86846666666668,2
76561198282026470,1133,7,6,0,0,1,0,4,3,5,7,11,344.2674500000001,9
76561197977407379,810,6,4,2,0,0,0,4,2,5,6,13,149.17987999999997,6
76561198410199441,1754,15,9,5,0,1,0,10,5,5,15,11,126.0821928571429,9
76561198189801561,945,9,8,0,0,1,0,6,3,4,9,10,214.9854125,7
76561198359172139,1287,16,13,3,0,0,0,13,3,3,16,10,163.0934266666667,4
76561198357371855,921,7,3,0,0,3,1,6,1,5,7,11,314.7200666666667,9
76561198323013640,1044,10,4,6,0,0,0,9,1,5,10,11,200.85866666666666,8
76561198044544513,2134,21,18,0,3,0,0,19,2,5,21,9,125.09296000000003,9
76561197996876150,915,7,7,0,0,0,0,5,2,4,7,11,335.4777,7
76561198023832249,1170,10,7,3,0,0,0,10,0,4,10,11,261.40880000000004,6
76561198193315702,967,9,7,0,1,1,0,5,4,5,9,8,233.3584125,3
76561198119152682,866,4,3,0,0,1,0,4,0,5,4,10,219.99743333333336,8
76561198145860136,108,1,0,1,0,0,0,1,0,5,1,6,0.0,3
76561198164955633,1305,14,4,3,5,1,1,11,3,4,14,8,137.43615384615384,5
76561198249015896,458,3,3,0,0,0,0,2,1,5,3,8,840.4062999999999,5
76561198063781152,506,3,1,1,1,0,0,3,0,5,3,8,583.5759999999999,4
76561198055675563,1124,14,6,5,2,1,0,10,4,5,14,6,142.1146,3
76561198119450462,1419,13,12,1,0,0,0,10,3,4,13,5,133.0277166666667,4
76561197961424834,529,5,2,3,0,0,0,4,1,5,5,7,365.188075,2
76561198068609350,594,5,3,0,0,0,0,3,2,5,5,5,317.58815000000004,3
76561198022578849,1353,15,3,8,2,2,0,12,3,5,15,8,194.0570285714286,4
76561198305241085,779,5,4,0,1,0,0,5,0,5,5,13,299.3175,4
76561197980629901,1683,17,12,0,5,0,0,15,2,3,17,8,174.7301875,8
76561198171228730,1018,9,3,2,3,1,0,7,2,5,9,10,265.1532625,5
76561198145191198,594,6,5,0,0,1,0,6,0,4,6,11,413.68149999999997,3
76561198084370298,1521,16,11,5,0,0,0,16,0,5,16,8,170.97284666666667,4
76561198354032604,985,9,5,2,1,1,0,8,1,4,9,12,337.9785375,4
76561198359172139,529,6,6,0,0,0,0,4,2,4,6,9,556.4862000000002,4
76561198000287821,1145,10,8,0,0,2,0,9,1,5,10,12,277.0544333333333,9
76561197977407379,1078,9,7,1,0,1,0,8,1,5,9,11,275.584225,4
76561198045811799,1212,11,5,4,0,2,0,6,5,4,11,8,208.46856000000002,5
76561198207869232,1008,11,9,1,1,0,0,10,1,4,11,8,202.48927,4
76561198272930218,1036,10,0,6,1,3,0,10,0,5,10,11,143.31255555555563,4
76561198321559003,1103,12,7,4,1,0,0,9,3,5,12,8,191.40358181818183,4
76561198196957990,696,4,1,3,0,0,0,4,0,5,4,8,517.2358,6
76561197997452441,1362,9,8,1,0,0,0,8,1,3,9,10,257.0068625,11
76561198155382995,564,6,6,0,0,0,0,4,2,4,6,9,373.94755999999995,4
76561198014298831,1153,10,7,1,1,1,0,9,1,5,10,9,264.19705555555555,7
76561198027299836,650,6,2,3,0,1,0,6,0,5,6,9,436.2157800000001,4
76561197962420322,1281,12,8,3,0,1,0,10,2,5,12,11,197.12918181818188,5
76561197977407379,999,11,8,1,0,2,0,11,0,5,11,8,188.30737000000002,3
76561198304619846,781,7,7,0,0,0,0,6,1,5,7,8,212.69909999999996,5
76561198105504533,1185,11,4,5,2,0,0,9,2,3,11,7,185.42947000000007,7
76561198171209183,1044,10,7,0,0,3,0,10,0,3,10,7,206.4325111111111,6
76561198000287821,927,8,8,0,0,0,0,8,0,5,8,7,202.75778571428572,6
76561198158117480,379,2,0,1,0,0,0,2,0,5,2,9,203.88799999999992,6
76561198312232330,743,6,2,2,1,1,0,5,1,5,6,9,350.25758,5
76561198288246701,902,9,7,0,0,1,0,9,0,4,9,11,233.55815,2
76561197963699938,936,7,1,3,3,0,0,7,0,4,7,9,287.54876666666667,6
76561198412239520,1050,12,5,3,3,1,0,7,5,5,12,8,158.1870181818182,1
76561198262899586,890,9,2,2,5,0,0,8,1,5,9,8,208.4229625,5
76561198179548187,836,11,6,3,2,0,0,9,2,5,11,6,156.26938,2
76561197981094803,1068,9,8,0,0,1,0,9,0,4,9,6,203.27375,4
76561197998803307,1405,12,6,6,0,0,0,12,0,4,12,8,157.98971818181823,6
76561198314046612,409,3,0,1,2,0,0,3,0,5,3,10,332.5728,4
76561198179086106,228,2,2,0,0,0,0,2,0,5,2,8,7.100300000000061,6
76561198344615718,784,8,1,6,1,0,0,8,0,5,8,9,218.50985714285721,3
76561198061302538,1435,15,7,8,0,0,0,13,2,3,15,6,121.28387142857142,2
76561198002485645,916,8,8,0,0,0,0,8,0,5,8,11,227.9338142857143,4
76561198002483125,700,4,4,0,0,0,0,4,0,5,4,9,219.0046666666667,6
76561198046393754,924,8,8,0,0,0,0,8,0,5,8,11,241.9616,4
76561198184283911,1016,8,8,0,0,0,0,7,1,5,8,9,183.07219999999998,8
76561198242143470,913,7,6,0,0,1,0,6,1,3,7,9,276.56801666666667,5
76561198317145102,743,10,10,0,0,0,0,9,1,4,10,7,176.51156666666668,2
76561198191807569,417,4,2,2,0,0,0,4,0,5,4,15,136.02300000000005,1
76561198156291661,1738,20,5,15,0,0,0,19,1,5,20,6,94.60935263157894,2
76561198276920713,1333,15,5,10,0,0,0,14,1,4,15,6,129.69569285714286,1
76561198124335697,892,5,4,1,0,0,0,5,0,5,5,10,321.243925,6
76561198005113325,802,9,9,0,0,0,0,9,0,5,9,9,166.2565875,4
76561198331560196,175,2,0,0,0,2,0,1,1,5,2,6,635.798,2
76561198317070431,977,8,2,0,1,5,0,7,1,5,8,8,235.41105714285715,9
76561198201257362,217,2,2,0,0,0,0,2,0,5,2,7,468.02690000000007,2
76561198349225198,424,5,1,1,2,0,0,5,0,3,5,6,151.80245000000002,5
76561198155497645,659,4,3,1,0,0,0,3,1,4,4,9,439.4069666666667,6
76561198150001794,668,6,2,2,2,0,0,4,2,3,6,9,303.17032,3
76561198044028830,662,5,5,0,0,0,0,4,1,5,5,5,345.933225,7
76561198277550111,1220,11,1,7,3,0,0,10,1,5,11,4,114.25307000000001,6
76561198221512652,834,8,3,2,0,3,0,6,2,4,8,5,139.4373,2
76561198138882365,882,9,4,4,0,0,1,8,1,5,9,6,91.66593749999998,5
76561198303917869,535,5,5,0,0,0,0,5,0,5,5,4,287.78937500000006,5
76561198104642358,884,6,2,2,0,2,0,6,0,5,6,6,260.19039999999995,6
76561198204420993,687,6,2,4,0,0,0,5,1,4,6,7,248.85714,4
76561198334475016,840,7,3,2,1,1,0,5,2,4,7,3,241.23080000000002,3
76561198244040128,926,12,11,1,0,0,0,8,4,4,12,2,129.3953818181818,4
76561198329119580,300,3,2,0,1,0,0,1,2,5,3,6,376.318,0
76561198261666700,347,3,1,0,2,0,0,2,1,4,3,7,229.90050000000014,3
76561198359851590,444,3,2,0,1,0,0,3,0,5,3,8,222.35214999999988,3
76561198314818082,577,4,1,2,0,1,0,3,1,5,4,6,484.62866666666673,6
76561198044028830,824,6,5,0,0,1,0,3,3,5,6,7,286.34514,6
76561198221512652,609,8,5,0,0,3,0,7,1,3,8,6,187.96225714285714,3
76561198221512652,851,5,3,0,0,2,0,5,0,5,5,11,136.43192499999998,8
76561198044028830,835,9,9,0,0,0,0,7,2,5,9,12,282.70968750000003,9
76561198162784085,1582,13,10,0,1,2,0,13,0,4,13,12,179.92200833333334,8
76561198318998676,1174,13,0,12,1,0,0,10,3,5,13,9,175.3195333333333,2
76561198302527588,752,7,5,2,0,0,0,6,1,5,7,9,364.44893333333334,5
76561198053703775,1083,10,8,1,0,1,0,8,2,5,10,9,251.10642222222225,5
76561198393757241,1542,11,6,2,2,1,0,8,3,4,11,11,204.54180000000005,10
76561198390491011,1307,15,13,0,0,1,1,15,0,4,15,7,153.654,6
76561198117815276,637,6,4,2,0,0,0,5,1,5,6,9,311.60884000000004,5
76561197999707171,1070,11,9,1,0,1,0,10,1,5,11,11,201.81930000000003,2
76561198350997137,1126,7,6,1,0,0,0,6,1,4,7,10,257.00556666666665,8
76561198292710055,854,4,3,0,0,1,0,4,0,5,4,10,174.68826666666658,8
76561198159626736,1037,8,4,0,1,2,0,6,2,3,8,12,228.3451,7
76561198380549785,1154,20,8,0,1,10,0,15,5,5,20,11,83.41979473684215,4
76561198085978835,810,10,7,2,0,1,0,10,0,5,10,9,121.4419777777778,4
76561198095683624,964,7,7,0,0,0,0,6,1,5,7,16,262.95421666666664,8
76561197977407379,1171,10,9,1,0,0,0,8,2,5,10,9,186.5680555555556,6
76561198122576828,2272,22,22,0,0,0,0,15,7,4,22,7,80.59918571428572,3
76561198170555157,528,4,2,1,1,0,0,3,1,3,4,10,558.7355333333334,5
76561198168024562,794,10,10,0,0,0,0,7,3,5,10,8,179.01165555555556,2
76561198201883567,946,4,3,0,0,1,0,4,0,5,4,8,475.67096666666663,8
76561198085632080,440,7,5,2,0,0,0,6,1,5,7,7,236.26238333333336,3
76561198147132751,501,7,6,0,1,0,0,3,4,5,7,7,209.42463333333333,5
76561198101009958,998,8,5,2,1,0,0,4,4,3,8,5,218.0354857142857,4
76561198286013927,669,5,5,0,0,0,0,3,2,4,5,7,391.6729,6
76561198343218229,1020,9,9,0,0,0,0,7,2,4,9,6,181.6740375,6
76561198147621097,641,6,5,1,0,0,0,4,2,4,6,7,312.65088000000003,4
76561198105205457,783,7,5,2,0,0,0,6,1,5,7,5,253.21298333333334,4
76561198225629680,948,8,8,0,0,0,0,4,4,5,8,7,210.94945714285714,5
76561198119624494,338,4,1,3,0,0,0,4,0,4,4,6,441.82169999999996,2
76561198108289325,719,7,1,6,0,0,0,7,0,5,7,4,134.01161666666667,5
76561198343804451,498,5,3,1,0,1,0,5,0,5,5,5,101.84882499999999,4
76561198137462844,502,5,5,0,0,0,0,5,0,4,5,2,255.0987,3
76561198069023995,741,8,5,2,1,0,0,8,0,3,8,3,118.32768571428574,4
76561198087983835,303,2,1,0,0,0,1,2,0,5,2,4,106.42790000000002,4
76561198202089910,714,5,5,0,0,0,0,5,0,5,5,6,89.994875,4
76561198012974021,220,2,2,0,0,0,0,2,0,5,2,5,211.9190000000001,3
76561198278051780,579,6,4,1,0,1,0,5,1,4,6,5,193.7457,2
76561198011424983,258,1,1,0,0,0,0,1,0,5,1,6,0.0,4
76561198093732979,402,4,2,2,0,0,0,4,0,5,4,5,251.3635333333335,1
76561198038224434,752,6,6,0,0,0,0,6,0,5,6,10,463.92389999999995,5
76561198261245133,946,8,5,0,0,3,0,8,0,5,8,10,245.24084285714284,7
76561198167441976,1362,13,0,12,0,1,0,13,0,4,13,8,179.606175,4
76561198329071198,1020,9,6,0,0,2,1,6,3,3,9,7,270.1867000000001,5
76561198194077073,774,7,1,3,1,2,0,4,3,5,7,10,251.7741666666667,4
76561198088766726,917,7,4,3,0,0,0,7,0,5,7,9,379.40903333333335,5
76561198146972559,664,5,5,0,0,0,0,4,1,5,5,10,311.374675,6
76561198131753340,1017,15,11,2,0,2,0,13,2,4,15,6,162.73782857142857,3
76561198322900878,1149,9,8,0,1,0,0,8,1,5,9,9,189.99487500000004,10
76561198263527476,1040,9,5,1,1,2,0,8,1,5,9,9,236.4964625,6
76561198174849817,906,2,2,0,0,0,0,1,1,5,2,13,571.2629999999999,16
76561198089855016,1830,18,13,3,0,1,0,13,5,5,18,12,150.0143705882353,8
76561198301998635,1091,13,9,2,1,0,0,8,5,4,13,10,211.4734083333334,7
76561198137724380,1817,17,9,8,0,0,0,14,3,5,17,13,125.6201875,11
76561198323407897,1032,14,13,0,0,0,1,8,6,5,14,12,127.39669230769232,11
76561198345046917,1345,16,10,0,0,6,0,7,9,5,16,15,167.98272666666665,5
76561198363614402,1515,10,8,0,0,2,0,9,1,5,10,10,197.3977,12
76561198132376628,1097,10,2,8,0,0,0,9,1,5,10,17,248.73791111111112,5
76561198348663932,1536,14,12,0,0,1,1,11,3,5,14,9,179.5334769230769,7
76561198364831274,974,10,8,0,0,2,0,9,1,4,10,13,273.40086666666673,6
76561198191105919,848,8,4,1,0,3,0,8,0,5,8,10,278.365,7
76561198322970106,1060,10,2,5,1,2,0,8,2,5,10,9,153.9660888888889,6
76561198028331480,1027,10,7,1,2,0,0,7,3,4,10,6,233.9599222222222,4
76561198130590948,1268,13,6,7,0,0,0,10,3,3,13,7,173.11019166666665,4
76561198043568853,773,8,4,1,1,2,0,8,0,5,8,9,218.14672857142855,4
76561198107729857,601,6,3,1,0,1,0,5,1,5,6,10,355.43746,4
76561198035959279,958,7,6,0,0,0,1,7,0,5,7,10,327.3479833333334,8
76561198201093317,1071,9,4,1,1,2,1,6,3,4,9,9,251.8595875,4
76561198103725373,1167,10,2,7,0,1,0,9,1,3,10,8,224.98292222222224,3
76561198142317460,681,8,6,0,0,2,0,7,1,5,8,11,176.78814285714284,5
76561197962601009,1028,9,6,0,0,3,0,8,1,5,9,11,269.8914750000001,7
76561198284620960,1030,9,7,0,0,0,0,9,0,4,9,10,338.33435000000003,8
76561198000651114,1034,11,7,0,0,4,0,9,2,5,11,11,202.47700000000003,8
76561198171469541,1446,12,0,11,0,1,0,11,1,3,12,13,248.8890909090909,7
76561198056524985,1227,11,10,0,0,1,0,4,7,3,11,9,188.94082,9
76561198002907836,1056,13,13,0,0,0,0,8,5,5,13,9,208.26870833333336,3
76561198034010786,1199,8,8,0,0,0,0,3,5,5,8,12,189.05557142857143,11
76561198337681150,862,10,9,0,1,0,0,6,4,5,10,9,240.44887777777785,7
76561198275745553,1077,10,6,2,0,2,0,8,2,4,10,12,299.9878888888889,7
76561197992531569,1525,13,10,3,0,0,0,12,1,5,13,10,175.66041666666672,7
76561198129992335,752,8,2,6,0,0,0,7,1,5,8,4,157.95595714285716,2
76561198314025557,579,5,3,2,0,0,0,4,1,4,5,2,267.443775,3
76561198300392290,310,1,1,0,0,0,0,1,0,4,1,3,0.0,6
76561198262787454,322,3,3,0,0,0,0,3,0,3,3,3,514.5848,1
76561198191993241,263,4,4,0,0,0,0,2,2,5,4,4,263.10670000000005,2
76561197969004217,424,3,0,2,1,0,0,3,0,5,3,5,383.5784000000001,2
76561198245651302,496,7,3,1,2,1,0,3,4,5,7,3,142.71788333333333,3
76561198059612839,236,1,1,0,0,0,0,1,0,5,1,5,0.0,2
76561198294197895,552,4,4,0,0,0,0,4,0,5,4,4,25.39300000000003,3
76561198013128832,164,1,1,0,0,0,0,1,0,5,1,4,0.0,2
76561198137618710,658,4,2,0,0,2,0,4,0,5,4,8,443.249,6
76561198130694160,740,7,2,4,1,0,0,7,0,5,7,7,133.18196666666668,5
76561198145271397,980,11,2,7,2,0,0,8,3,4,11,7,148.48459,2
76561198333119399,577,4,4,0,0,0,0,4,0,4,4,8,502.06483333333335,9
76561198171000165,665,6,5,0,1,0,0,6,0,5,6,8,183.30522000000002,3
76561197992836355,955,8,7,0,0,1,0,8,0,5,8,6,228.1378714285714,6
76561197989197531,786,9,7,0,1,1,0,7,2,4,9,5,165.5307625,5
76561197996414901,638,2,1,1,0,0,0,2,0,5,2,8,492.80200000000013,8
76561197965400418,1042,12,12,0,0,0,0,9,3,5,12,5,115.99853636363638,4
76561198000239250,493,6,3,0,0,3,0,4,2,5,6,7,248.13270000000003,2
76561198083851656,913,8,7,0,1,0,0,6,2,5,8,6,242.92075714285713,8
76561198151956262,860,6,6,0,0,0,0,5,1,5,6,6,317.81571999999994,5
76561198161860645,1231,14,0,12,2,0,0,13,1,4,14,3,128.9448923076923,2
76561198276850531,400,3,2,1,0,0,0,2,1,5,3,5,178.16190000000006,5
76561198206812669,383,6,6,0,0,0,0,6,0,3,6,5,311.15183999999994,4
76561198189351383,1139,9,3,4,2,0,0,9,0,5,9,9,197.7126625,4
76561198169339289,296,3,3,0,0,0,0,3,0,4,3,8,789.3505,3
76561198030249763,644,6,5,1,0,0,0,4,2,4,6,7,338.0698000000001,3
76561198348012108,613,5,5,0,0,0,0,3,2,5,5,7,393.33894999999995,3
76561198022844269,227,2,1,1,0,0,0,1,1,5,2,6,186.75700000000006,2
76561198064742200,1359,14,4,6,2,0,2,14,0,5,14,9,136.05255384615387,4
76561198219540837,1334,10,10,0,0,0,0,8,2,4,10,6,218.68123333333332,8
76561198126385701,199,2,0,1,0,1,0,2,0,5,2,10,1737.5202000000002,4
76561198002183589,1659,18,18,0,0,0,0,13,5,5,18,5,101.65550588235298,3
76561198193830101,577,5,4,0,0,0,1,4,1,5,5,8,425.979875,8
76561198228624680,744,4,1,0,0,3,0,4,0,5,4,9,333.05933333333337,5
76561198257314133,1031,11,9,1,1,0,0,9,2,5,11,10,175.68374000000009,3
76561198072064806,481,5,1,0,1,3,0,3,2,4,5,11,495.47094999999996,2
76561198004222916,1125,11,5,2,4,0,0,11,0,5,11,9,182.67267999999999,4
76561198238985764,1057,7,5,1,1,0,0,7,0,4,7,10,236.06510000000003,9
76561198161288585,930,10,4,6,0,0,0,8,2,5,10,11,233.68354444444444,2
76561197970149253,1271,7,3,1,0,3,0,7,0,4,7,13,379.35746666666665,15
76561198064762458,1275,13,13,0,0,0,0,10,3,4,13,10,197.0170083333334,8
76561197966120083,1819,19,10,6,2,1,0,18,1,5,19,10,127.6655388888889,8
76561197968126959,816,6,5,0,0,1,0,6,0,5,6,14,370.77236000000005,5
76561198115583936,1253,9,8,0,0,0,1,8,1,5,9,14,248.5196625,9
76561198075648755,1516,16,2,11,3,0,0,15,1,5,16,10,157.98692666666665,4
76561197987633842,1232,10,9,1,0,0,0,9,1,4,10,10,248.8034333333333,10
76561198101669937,1242,11,11,0,0,0,0,11,0,5,11,9,219.09309000000002,5
76561198048525062,1019,12,10,0,0,1,1,10,2,4,12,12,205.42345454545458,3
76561198373020617,905,9,8,0,1,0,0,6,3,5,9,9,153.1250375,3
76561198346887313,1271,14,14,0,0,0,0,8,6,5,14,4,153.9771153846154,1
76561198380396535,540,4,0,3,0,1,0,3,1,4,4,7,658.0137333333334,5
76561198094744430,906,9,6,2,0,1,0,6,3,5,9,6,185.74812500000002,4
76561198023317027,1073,10,9,0,0,0,1,6,4,5,10,6,179.74739999999997,3
76561198346530625,1100,8,7,0,0,0,1,6,2,5,8,9,315.0251571428571,8
76561198307582222,529,2,1,1,0,0,0,2,0,5,2,9,491.27599999999984,7
76561198261378402,676,6,1,3,1,0,0,6,0,5,6,9,371.84152,2
76561198115128897,976,10,9,1,0,0,0,6,4,4,10,10,193.98958888888887,4
76561198336642678,615,6,6,0,0,0,0,6,0,5,6,9,269.08561999999995,3
76561198125545428,1417,11,2,4,2,2,1,10,1,5,11,10,242.99614000000005,7
76561198172393593,899,8,0,1,2,4,1,5,3,5,8,9,373.7498428571429,9
76561198334389599,1433,24,20,0,3,1,0,13,11,4,24,6,113.7934434782609,4
76561198396646436,1786,27,9,0,0,18,0,16,11,5,27,10,97.04370384615383,6
76561198089964608,684,6,4,1,1,0,0,5,1,5,6,9,480.19741999999997,4
76561198363269809,1186,8,2,2,2,2,0,5,3,5,8,21,378.3088285714286,9
76561197984342751,1581,18,6,8,2,2,0,12,6,4,18,24,154.31987647058827,4
76561198023317027,1613,15,15,0,0,0,0,11,4,3,15,10,179.67700714285715,7
76561198038817349,159,0,0,0,0,0,0,0,0,0,0,4,0.0,4
76561198013104221,589,3,1,1,0,1,0,1,2,5,3,17,977.7762,7
76561198159632618,1207,8,8,0,0,0,0,6,2,4,8,7,336.3321714285715,8
76561198082757664,1083,10,1,6,2,1,0,9,1,5,10,9,262.06745555555557,2
76561198070709648,1007,10,6,3,0,0,0,8,2,5,10,9,281.4983111111111,5
76561198037714592,369,4,3,1,0,0,0,4,0,4,4,10,605.7721666666666,2
76561198068485762,1008,12,12,0,0,0,0,11,1,3,12,6,176.09330909090914,6
76561198219222079,779,5,2,0,0,1,1,5,0,5,5,10,263.23,7
76561198017250315,1081,9,3,4,2,0,0,7,2,5,9,9,238.72533750000002,6
76561198170735670,971,12,10,0,0,1,1,10,2,5,12,8,169.6574272727273,3
76561198311448598,645,6,0,6,0,0,0,6,0,5,6,9,181.70980000000003,5
76561198125526604,966,8,6,2,0,0,0,5,3,4,8,7,362.2076,3
76561198120490532,1161,13,2,10,1,0,0,11,2,5,13,4,133.87381666666667,3
76561198084028030,1260,13,9,1,0,3,0,12,1,4,13,6,136.8039416666667,6
76561198114885004,982,6,6,0,0,0,0,5,1,5,6,7,268.36964,6
76561198006570423,430,3,1,2,0,0,0,3,0,3,3,8,264.93465000000003,5
76561198085645406,553,5,2,3,0,0,0,4,1,5,5,6,123.94242499999999,4
76561198156857217,464,4,0,1,0,3,0,3,1,5,4,8,168.58010000000002,2
76561198101893197,594,7,5,2,0,0,0,6,1,5,7,9,238.76356666666666,2
76561198153910541,824,8,7,1,0,0,0,8,0,4,8,8,130.91015714285712,4
76561198095101736,771,6,2,4,0,0,0,5,1,5,6,8,236.89554000000004,4
76561198164081644,738,6,4,1,0,1,0,5,1,5,6,7,293.5051,4
76561198300319060,1258,18,6,8,1,2,0,17,1,5,18,4,74.54701764705882,1
76561198205873275,1093,10,5,5,0,0,0,8,2,5,10,5,134.7683111111111,3
76561198318971100,372,3,0,3,0,0,0,3,0,3,3,5,226.67450000000008,2
76561198241985942,380,2,2,0,0,0,0,2,0,5,2,5,1094.5085,3
76561198360003369,516,2,2,0,0,0,0,1,1,5,2,8,370.92719999999997,5
76561198354096842,645,5,4,1,0,0,0,4,1,4,5,6,305.998025,5
76561198023317027,799,8,8,0,0,0,0,5,3,4,8,6,177.09554285714285,2
76561197999237168,201,2,2,0,0,0,0,2,0,5,2,8,2.1591000000000804,2
76561197984342751,706,7,1,6,0,0,0,6,1,5,7,7,174.18316666666666,2
76561198076100521,718,5,5,0,0,0,0,5,0,5,5,8,79.30779999999999,4
76561198386725237,788,4,1,3,0,0,0,3,1,5,4,13,101.5846666666667,8
76561198260131058,413,2,1,0,1,0,0,1,1,3,2,15,1948.2997,4
76561198059778702,1678,17,7,7,0,3,0,14,3,5,17,12,135.611575,4
76561198259345900,411,4,3,1,0,0,0,1,3,5,4,13,515.6333333333333,5
76561198312988164,851,7,2,1,0,4,0,6,1,4,7,15,357.63528333333335,6
76561198342856172,913,9,4,2,0,3,0,8,1,5,9,8,249.55830000000003,5
76561198309546898,1497,17,8,7,1,0,1,13,4,5,17,3,154.0569875,4
76561198353323906,1061,9,8,0,0,1,0,7,2,4,9,9,301.9681,7
76561198375304038,2499,24,0,21,1,2,0,18,6,4,24,9,104.96038260869565,3
76561198184630013,959,9,7,0,0,0,1,7,2,5,9,5,273.817525,4
76561198309743553,1014,9,8,0,0,1,0,8,1,4,9,6,214.74380000000005,4
76561198196210254,600,5,1,1,0,2,1,5,0,5,5,7,572.5019500000001,5
76561198254776754,391,3,0,3,0,0,0,2,1,4,3,6,876.0406,1
76561198227525564,1343,11,2,9,0,0,0,10,1,3,11,7,174.41115999999997,5
76561198215447760,784,7,5,0,1,1,0,6,1,5,7,8,278.6156666666667,5
76561198156093907,1011,10,5,4,1,0,0,10,0,5,10,6,261.37338888888894,3
76561198296003938,749,7,7,0,0,0,0,5,2,3,7,7,386.8978666666667,5
76561198355986329,983,10,9,0,0,0,1,10,0,5,10,10,189.18522222222222,3
76561198293312731,539,4,1,2,1,0,0,3,1,5,4,6,437.5253333333332,5
76561198343370880,437,3,1,0,0,2,0,3,0,5,3,6,712.3120000000004,3
76561197993149859,1430,11,8,0,0,2,1,10,1,5,11,9,198.15864000000002,9
76561198265845129,1318,16,16,0,0,0,0,13,3,4,16,10,155.6516,1
76561198577895507,864,8,4,3,1,0,0,7,1,5,8,11,255.95167142857142,5
76561198168929625,862,6,6,0,0,0,0,6,0,5,6,12,298.92920000000015,9
76561198380504694,740,6,4,2,0,0,0,4,2,5,6,11,221.71479999999997,6
76561198312787335,2400,27,19,8,0,0,0,22,5,5,27,7,90.85337307692308,6
76561198012031445,928,5,4,1,0,0,0,5,0,4,5,10,561.1796750000001,9
76561198321420303,1014,7,6,0,0,1,0,7,0,5,7,11,178.30233333333328,10
76561198052642384,279,3,3,0,0,0,0,3,0,5,3,12,683.1494999999999,4
76561197982536298,1139,11,10,0,0,1,0,10,1,5,11,7,148.46120000000002,7
76561198126678514,1151,10,2,2,3,2,0,8,2,5,10,13,262.7373111111111,7
76561198340412267,1390,14,3,7,1,3,0,11,3,5,14,12,138.02015384615385,8
76561198297091831,1922,16,10,0,4,2,0,16,0,3,16,12,168.16492666666664,11
76561198310001550,917,7,5,0,1,1,0,6,1,4,7,13,420.8342666666667,7
76561198265845129,1007,7,4,0,3,0,0,5,2,5,7,11,252.4421166666667,6
76561198296457999,1660,19,17,0,0,2,0,17,2,5,19,12,101.66237777777779,5
76561198079658288,1254,10,8,0,1,1,0,10,0,5,10,10,190.23936666666668,8
76561198313569499,2081,20,14,5,0,1,0,18,2,4,20,10,133.55796315789476,9
76561198282573663,860,6,2,0,0,4,0,5,1,5,6,10,314.33238,10
76561198123988023,761,5,3,0,2,0,0,5,0,5,5,11,375.4127,5
76561198191238615,749,8,8,0,0,0,0,7,1,5,8,2,90.42064285714284,3
76561198201348442,235,1,0,1,0,0,0,0,1,4,1,2,0.0,2
76561198155115183,855,8,4,4,0,0,0,8,0,4,8,3,221.84397142857142,3
76561197970104038,357,5,3,0,0,0,2,4,1,5,5,2,134.007625,1
76561198078958929,60,0,0,0,0,0,0,0,0,0,0,3,0.0,1
76561197985023967,306,1,1,0,0,0,0,0,1,5,1,4,0.0,5
76561198340910120,604,5,2,2,1,0,0,3,2,4,5,4,387.898225,4
76561198048608095,236,3,3,0,0,0,0,2,1,5,3,4,782.74145,2
76561198153516220,207,1,0,0,0,0,1,1,0,5,1,5,0.0,2
76561198070785256,255,2,2,0,0,0,0,2,0,5,2,5,518.4486999999999,2
76561198017826068,737,5,4,0,0,1,0,4,1,5,5,10,139.07675000000017,8
76561198265845129,893,11,8,0,0,2,1,9,2,5,11,8,204.48847,4
76561198319850161,1267,12,5,4,0,3,0,11,1,5,12,9,220.76779090909093,7
76561197961257994,800,7,0,6,1,0,0,7,0,4,7,8,351.93580000000003,4
76561198286606192,153,1,1,0,0,0,0,1,0,5,1,9,0.0,2
76561198252508710,900,8,1,4,1,2,0,7,1,5,8,7,287.50077142857145,4
76561198158797470,1087,11,5,2,0,4,0,9,2,4,11,6,247.6202800000001,3
76561198039205946,1110,10,7,2,0,1,0,9,1,3,10,7,267.3685444444444,5
76561198192411994,972,7,5,0,1,0,0,6,1,5,7,9,319.7848333333333,7
76561198040936153,555,8,3,1,0,2,2,7,1,5,8,7,221.56171428571432,3
76561198384471964,1713,20,7,11,0,1,1,13,7,5,20,12,125.13298421052632,4
76561198023317027,1586,12,4,6,0,2,0,7,5,5,12,11,223.91922727272728,12
76561198177313262,1368,10,7,0,0,3,0,8,2,5,10,16,164.90413333333333,12
76561198326166283,1074,8,6,0,0,0,0,5,3,4,8,12,285.6236285714286,9
76561198283487617,1428,17,11,4,1,1,0,9,8,3,17,12,152.73128125000002,7
76561198313567888,1800,14,12,0,0,2,0,10,4,5,14,15,174.72344615384617,13
76561198202038369,1423,19,14,2,1,1,1,13,6,5,19,13,136.8360722222222,5
76561198315987165,1090,9,5,2,0,2,0,6,3,4,9,13,277.34973750000006,7
76561198311904799,1141,11,10,1,0,0,0,11,0,4,11,12,230.44769000000005,5
76561198279656779,1483,10,5,0,2,3,0,9,1,5,10,14,227.20515555555556,7
76561198365825497,1468,12,9,3,0,0,0,10,2,5,12,8,157.4493,7
76561197973576874,860,7,5,0,0,1,1,4,3,3,7,4,315.4881,7
76561198099469104,734,7,6,0,0,1,0,7,0,4,7,6,302.07003333333336,4
76561198188994942,881,9,7,0,1,0,0,8,1,5,9,7,114.39550000000003,4
76561198079444984,907,10,1,8,1,0,0,9,1,3,10,6,191.61854444444447,3
76561198193997222,523,4,1,0,1,0,0,2,2,5,4,10,555.9367333333333,4
76561198154171748,1130,8,6,1,1,0,0,6,2,4,8,10,257.6223,7
76561198271886908,148,1,1,0,0,0,0,1,0,5,1,10,0.0,3
76561198078381494,1379,16,12,0,2,1,1,12,4,5,16,8,101.47792,2
76561198146972300,425,3,0,1,2,0,0,2,1,5,3,8,359.8364999999999,3
76561198080170380,1290,10,7,0,0,3,0,7,3,3,10,10,299.3047888888889,7
76561198136962467,1251,10,4,0,1,5,0,6,4,5,10,14,288.4424000000001,10
76561198265845129,1370,17,16,0,0,1,0,14,3,5,17,11,153.6500875,11
76561198037493772,1352,14,10,0,0,3,1,9,5,5,14,12,187.54025384615386,10
76561198167730449,1044,9,5,2,2,0,0,9,0,5,9,13,261.37253749999996,6
76561198143724354,1245,12,6,4,0,2,0,9,3,5,12,11,248.56235454545455,4
76561198134395238,1741,12,10,2,0,0,0,11,1,3,12,13,230.7049909090909,10
76561198077468069,1288,12,10,0,0,2,0,8,4,4,12,11,249.1420090909091,9
76561198392946894,1273,12,11,0,0,0,1,10,2,4,12,12,250.25289999999998,8
76561198131135376,1295,12,7,4,0,1,0,11,1,5,12,13,221.82037272727274,7
76561198023317027,722,6,2,3,0,1,0,6,0,5,6,5,305.84562,3
76561198131224145,539,5,0,4,0,0,0,4,1,4,5,4,381.83804999999995,2
76561198347812567,294,5,3,1,1,0,0,5,0,4,5,4,254.07947499999997,3
76561198205932439,831,7,7,0,0,0,0,7,0,3,7,1,247.08773333333332,2
76561198384471964,477,6,4,2,0,0,0,6,0,4,6,2,186.35829999999999,2
76561198016786107,199,1,0,0,0,1,0,1,0,5,1,6,0.0,5
76561198026484567,732,6,4,2,0,0,0,6,0,5,6,6,277.6368,4
76561198204867639,400,4,1,1,1,0,1,4,0,5,4,6,233.70856666666668,3
76561198075548974,454,3,1,1,0,0,0,2,1,4,3,6,715.9424,3
76561198324057136,331,2,1,0,0,1,0,2,0,5,2,5,996.9993,3
76561197970635817,1280,10,5,4,1,0,0,10,0,5,10,9,156.77214444444445,6
76561198247192982,1431,13,10,1,0,2,0,12,1,5,13,8,101.64243333333333,12
76561198377035020,2109,23,12,2,3,6,0,23,0,4,23,7,61.91468181818182,3
76561198406605405,785,4,1,1,1,1,0,4,0,5,4,9,341.49996666666675,6
76561198134394016,1026,11,4,0,7,0,0,11,0,5,11,6,110.29897000000001,6
76561198313818830,1044,9,5,3,0,0,0,7,2,3,9,11,166.643325,5
76561198165845920,820,5,4,0,0,1,0,5,0,5,5,13,195.15504999999996,5
76561198413313103,1527,15,13,0,2,0,0,15,0,4,15,10,97.66512857142858,9
76561198371032854,729,4,2,1,0,1,0,4,0,5,4,12,202.70146666666665,8
76561198393788960,640,5,0,0,4,0,1,5,0,5,5,14,204.9155750000001,6
76561198037545351,1950,19,12,4,0,3,0,14,5,5,19,12,128.87179444444442,12
76561198340352543,1911,16,12,0,1,3,0,9,7,5,16,14,141.70758666666663,11
76561198373002444,1481,15,2,11,2,0,0,7,8,5,15,12,126.11785714285715,9
76561198272107746,1158,10,9,0,0,1,0,7,3,4,10,14,199.4064222222222,11
76561198124361371,1754,14,8,1,1,4,0,5,9,5,14,13,133.66490769230768,9
76561198364831274,1275,12,7,2,2,1,0,7,5,5,12,15,146.62104545454548,10
76561198363614402,1913,18,14,2,1,1,0,15,3,5,18,14,105.80897058823528,9
76561198345046917,1381,12,8,0,1,2,1,4,8,4,12,14,172.7524090909091,11
76561198132376628,777,9,1,2,0,6,0,5,4,5,9,16,222.5973625,4
76561198348663932,1909,14,14,0,0,0,0,4,10,5,14,15,171.4770538461538,16
76561198353552149,651,6,3,0,3,0,0,6,0,4,6,7,405.07624000000004,6
76561197989582287,1106,10,9,1,0,0,0,10,0,5,10,8,200.43355555555556,5
76561198050425117,1167,11,3,8,0,0,0,8,3,5,11,6,178.85417999999999,3
76561198413749921,741,7,6,1,0,0,0,2,5,5,7,7,145.95333333333335,5
76561198381163915,668,8,2,5,0,0,1,3,5,5,8,7,218.0073285714286,3
76561198296972170,1112,12,5,7,0,0,0,7,5,5,12,8,162.8193727272727,2
76561198075189888,562,7,7,0,0,0,0,2,5,5,7,7,171.30268333333333,5
76561198051200260,640,5,1,3,0,0,1,4,1,5,5,8,340.610875,4
76561198384957361,274,1,0,0,0,1,0,1,0,5,1,7,0.0,3
76561198418818019,1343,10,10,0,0,0,0,8,2,4,10,12,192.1158777777778,6
76561198153915324,200,2,1,1,0,0,0,2,0,5,2,3,324.3636,0
76561198033873728,518,4,2,2,0,0,0,4,0,4,4,3,59.913300000000014,3
76561198059283957,292,2,1,0,0,1,0,2,0,5,2,3,304.6322,1
76561198344283692,403,3,3,0,0,0,0,3,0,3,3,3,214.5903,2
76561198361162373,17,0,0,0,0,0,0,0,0,0,0,7,0.0,1
76561198124173992,345,3,3,0,0,0,0,3,0,5,3,1,75.79845,2
76561198190339818,156,1,0,0,0,1,0,1,0,5,1,4,0.0,2
76561198144050335,279,2,1,1,0,0,0,2,0,5,2,2,254.4126,1
76561198144455694,274,3,2,0,0,1,0,3,0,4,3,3,151.8314,0
76561198241834948,673,10,10,0,0,0,0,10,0,5,10,1,32.023933333333325,0
76561198068748403,781,8,5,2,1,0,0,6,2,5,8,10,288.27448571428573,4
76561198073585417,721,7,6,0,0,1,0,5,2,4,7,11,337.4089666666667,7
76561198039372717,916,8,7,0,0,1,0,7,1,5,8,10,332.75675714285717,6
76561198325594289,1889,19,7,11,1,0,0,16,3,3,19,9,127.43645000000002,5
76561198346148822,1669,14,4,10,0,0,0,10,4,3,14,8,171.46193076923075,9
76561198097974203,764,4,3,0,0,0,0,3,1,5,4,12,595.7059666666668,9
76561197994993011,1456,14,10,2,0,2,0,13,1,5,14,12,173.68334615384617,6
76561198155289491,1348,13,5,6,2,0,0,12,1,5,13,11,158.73208333333332,4
76561197972534511,757,7,6,0,0,1,0,7,0,4,7,10,360.29151666666667,4
76561198054601537,1065,10,0,8,0,0,0,8,2,5,10,11,202.5238888888889,4
76561198078700943,1065,12,4,5,3,0,0,11,1,4,12,8,131.0467909090909,4
76561198050425117,809,6,1,5,0,0,0,6,0,5,6,9,116.11647999999998,4
76561198260859249,348,2,0,0,0,2,0,1,1,5,2,9,639.6595,6
76561198314796139,367,1,1,0,0,0,0,1,0,5,1,9,0.0,5
76561198352625450,479,4,4,0,0,0,0,2,2,5,4,8,368.47690000000006,3
76561198281257109,973,9,9,0,0,0,0,8,1,5,9,5,187.27700000000002,4
76561198348465703,530,4,3,1,0,0,0,3,1,5,4,7,253.01086666666671,4
76561198104655462,1270,12,12,0,0,0,0,10,2,4,12,5,100.28626363636364,3
76561198088458553,1225,14,0,12,2,0,0,10,4,5,14,4,106.79342307692309,1
76561198360076447,336,4,1,1,0,2,0,3,1,5,4,4,275.2664666666667,2
76561198172435751,574,8,3,2,1,1,0,6,2,4,8,8,235.85091428571428,6
76561198030312622,1191,16,15,0,1,0,0,14,2,3,16,5,129.19672666666668,3
76561198056329968,656,4,4,0,0,0,0,4,0,5,4,7,440.95520000000005,5
76561197995343670,596,2,0,2,0,0,0,2,0,5,2,9,704.2490000000007,6
76561198043616230,669,5,4,0,0,0,1,5,0,5,5,7,73.55324999999999,7
76561198185308783,870,8,7,1,0,0,0,6,2,5,8,6,270.1174142857143,3
76561198093978191,1135,9,9,0,0,0,0,7,2,5,9,6,222.35152499999998,5
76561198037452321,553,4,3,0,1,0,0,4,0,4,4,7,632.9302666666666,7
76561198070348453,1070,12,9,3,0,0,0,11,1,3,12,7,175.11186363636367,3
76561198007312731,337,2,2,0,0,0,0,2,0,5,2,8,341.2482000000001,3
76561198141695020,874,8,5,0,0,2,1,8,0,5,8,10,242.8339,7
76561198075761517,975,9,0,5,1,3,0,6,3,4,9,9,279.874575,6
76561198050425117,984,9,6,3,0,0,0,6,3,4,9,10,281.71475000000004,4
76561198157216895,1127,9,7,2,0,0,0,5,4,3,9,10,273.7133125,9
76561198141628753,687,9,3,4,1,1,0,6,3,5,9,9,255.92491249999998,4
76561198267923892,968,7,6,1,0,0,0,6,1,5,7,10,358.66349999999994,9
76561198313993146,1399,13,9,2,0,2,0,7,6,5,13,8,181.80089999999998,5
76561198405412040,1276,11,10,0,0,1,0,11,0,5,11,8,212.01004000000003,6
76561198102364130,1001,12,9,0,0,3,0,9,3,3,12,10,199.61830909090907,3
76561198292959550,521,4,4,0,0,0,0,3,1,5,4,7,99.85130000000008,3
76561198265845129,1388,14,13,0,0,1,0,12,2,5,14,7,235.16180000000006,9
76561198070996787,1392,13,11,0,0,2,0,11,2,5,13,7,242.3197583333334,7
76561197971000603,988,11,9,0,1,1,0,11,0,4,11,10,234.98888000000002,5
76561198277964258,953,8,2,4,2,0,0,6,2,5,8,7,227.22628571428575,7
76561198071145273,808,7,0,7,0,0,0,7,0,5,7,8,380.4963333333333,3
76561197962326359,537,3,2,0,0,1,0,3,0,5,3,12,546.4114999999999,8
76561198337270951,984,11,4,0,1,5,1,10,1,5,11,9,235.7017,5
76561198287399057,661,8,5,2,1,0,0,7,1,5,8,9,357.5535714285715,4
76561198184727807,1638,15,9,0,0,5,1,14,1,4,15,12,215.4299357142857,8
76561198334765842,562,3,0,1,0,2,0,3,0,5,3,12,526.4795,3
76561198412647966,650,5,5,0,0,0,0,5,0,5,5,6,479.60467500000004,6
76561198096127398,650,6,3,3,0,0,0,4,2,5,6,7,381.70205999999996,3
76561198074472685,789,10,5,4,1,0,0,9,1,5,10,8,258.15475555555554,3
76561198050425117,741,6,2,4,0,0,0,5,1,4,6,7,317.68506,4
76561198357704016,580,5,2,1,0,2,0,4,1,5,5,8,532.4260750000001,8
76561198407463356,245,2,1,0,0,1,0,2,0,5,2,4,230.1014,2
76561198023853800,663,5,4,0,0,1,0,3,2,5,5,9,245.9167500000002,6
76561198289576620,1168,13,1,11,1,0,0,8,5,4,13,6,161.06370833333332,2
76561198259596359,1179,12,7,3,2,0,0,10,2,5,12,6,189.54060909090904,3
76561198159995338,780,4,4,0,0,0,0,3,1,4,4,7,126.7296,6
76561198101500002,2110,18,18,0,0,0,0,14,4,5,18,11,137.73230588235296,10
76561198271640965,1073,8,2,5,1,0,0,7,1,4,8,12,236.08189999999996,8
76561198021325453,1077,13,1,7,5,0,0,9,4,4,13,13,186.91914166666666,6
76561198140542415,1296,11,3,4,0,4,0,9,2,5,11,14,138.52850000000004,7
76561198104838710,1049,8,8,0,0,0,0,4,4,5,8,11,291.9913571428571,11
76561198000795766,1064,9,6,2,0,1,0,8,1,4,9,13,242.8930250000001,7
76561198070996787,1207,13,9,2,0,2,0,8,5,5,13,12,195.86830833333337,6
76561198265845129,1858,15,14,0,1,0,0,11,4,5,15,9,120.42514285714287,13
76561197971000603,1245,13,11,0,1,1,0,10,3,4,13,12,195.02439166666667,6
76561198302775095,1202,11,9,0,0,1,0,6,5,3,11,12,230.40376999999998,9
76561198307253486,1187,8,4,2,0,2,0,6,2,5,8,14,180.88392857142858,7
76561198347812567,668,7,4,1,0,1,1,7,0,5,7,12,184.51500000000007,6
76561198191446877,1194,9,3,4,0,2,0,7,2,5,9,11,164.4036625,9
76561198023317027,1051,9,7,2,0,0,0,8,1,4,9,11,154.9405875,6
76561198062522720,1162,10,7,1,1,0,0,8,2,5,10,8,181.1999888888889,7
76561198282342319,1422,14,7,5,0,2,0,12,2,5,14,10,147.8428923076923,5
76561198046867142,1945,19,17,1,0,1,0,17,2,5,19,9,104.55446666666666,6
76561198263610483,752,7,7,0,0,0,0,6,1,5,7,8,252.37366666666665,7
76561198398661847,742,6,0,4,1,1,0,5,1,5,6,8,241.61620000000002,4
76561198074849851,998,10,8,2,0,0,0,8,2,4,10,8,172.22221111111114,5
76561198404279224,716,7,7,0,0,0,0,4,3,5,7,5,374.8245166666666,2
76561198070996787,523,7,5,0,0,2,0,7,0,5,7,6,378.0498666666668,5
76561198084177175,629,8,7,0,0,1,0,8,0,5,8,6,275.9995285714286,3
76561198368312722,785,7,4,1,1,1,0,6,1,5,7,6,159.0535,4
76561198265845129,579,3,1,0,0,2,0,3,0,4,3,4,647.2970000000004,6
76561198203217074,736,4,2,2,0,0,0,4,0,5,4,11,422.3606666666667,6
76561198372710307,1655,15,6,6,1,1,0,15,0,5,15,10,152.07280714285713,5
76561198339828613,491,5,4,0,0,1,0,5,0,4,5,7,481.52177499999993,3
76561198118710984,100,1,1,0,0,0,0,1,0,4,1,2,0.0,0
76561198024278396,221,2,2,0,0,0,0,2,0,5,2,2,38.298,2
76561197980374166,1049,9,8,1,0,0,0,8,1,5,9,7,315.57820000000004,7
76561197960827249,706,6,4,0,0,2,0,6,0,4,6,8,181.01226000000003,7
76561198382655814,473,6,3,1,0,2,0,5,1,3,6,6,499.20442,4
76561198275264598,1159,10,4,5,1,0,0,10,0,3,10,8,269.93423333333334,3
76561198201047261,395,4,2,1,1,0,0,4,0,5,4,10,470.94786666666664,1
76561198142258790,759,5,5,0,0,0,0,5,0,5,5,8,549.9906500000001,5
76561198146701296,2095,21,8,13,0,0,0,20,1,5,21,5,105.76243,4
76561198070109317,861,9,8,0,0,0,1,8,1,5,9,8,307.23573749999997,7
76561198180624566,212,3,2,0,0,0,1,3,0,4,3,7,290.5587,1
76561198103627716,138,1,0,0,0,1,0,0,1,5,1,7,0.0,2
76561198078369306,1466,12,12,0,0,0,0,12,0,5,12,9,163.80161818181816,9
76561198050425117,756,7,2,5,0,0,0,7,0,5,7,8,206.04503333333332,8
76561198068259521,807,8,4,0,1,1,0,5,3,4,8,6,273.8431428571429,7
76561198119738187,755,9,6,0,0,3,0,6,3,3,9,9,236.9990375,6
76561198249590420,880,6,2,0,1,3,0,5,1,5,6,9,296.15104000000014,8
76561198067176820,912,9,5,3,1,0,0,8,1,5,9,8,221.2381125,4
76561198036478394,927,6,2,2,0,2,0,5,1,5,6,10,380.51112,8
76561198417508913,1443,14,5,8,1,0,0,14,0,5,14,6,104.46491538461538,7
76561198317348082,654,8,5,2,1,0,0,6,2,4,8,9,271.99904285714285,2
76561198407315904,561,4,3,0,0,0,0,2,2,3,4,9,624.8605666666667,6
76561198370512454,1164,11,6,4,0,0,1,9,2,5,11,9,184.80063,8
76561198114212797,747,6,5,1,0,0,0,5,1,4,6,9,314.8034,5
76561198278169669,929,7,3,3,1,0,0,5,2,5,7,9,141.84461666666667,7
76561198277131871,776,7,0,2,0,5,0,4,3,5,7,9,198.07916666666668,6
76561198033476302,486,5,0,1,0,4,0,4,1,5,5,10,217.10350000000005,3
76561197971119863,944,9,3,6,0,0,0,5,4,5,9,6,243.06161250000002,1
76561198156291661,1893,20,16,3,0,1,0,18,2,4,20,7,95.61184736842105,5
76561198147100360,825,6,5,0,0,1,0,6,0,5,6,8,371.68294,7
76561198005113325,850,8,6,1,0,1,0,8,0,5,8,9,176.40400000000014,3
76561198331560196,256,3,0,0,0,3,0,1,2,4,3,6,561.9499999999999,1
76561198050425117,1035,9,4,5,0,0,0,8,1,5,9,14,291.1611250000001,4
76561198074039559,1472,15,12,2,0,1,0,10,5,5,15,12,162.29446428571427,9
76561198414606118,1048,9,9,0,0,0,0,8,1,4,9,13,315.09537500000005,7
76561198416752648,1169,10,7,1,1,1,0,8,2,5,10,11,244.93574444444448,6
76561198152369790,2383,22,18,3,1,0,0,18,4,3,22,12,125.50317619047622,7
76561198406538462,1457,15,10,3,0,1,1,13,2,5,15,14,191.45175714285713,7
76561198123550154,956,5,1,0,0,4,0,2,3,5,5,14,479.24782500000003,8
76561198170805833,1820,17,5,11,1,0,0,16,1,5,17,11,134.33426250000002,6
76561198349458040,1019,9,9,0,0,0,0,7,2,4,9,11,315.20481249999995,7
76561198315046243,1757,15,9,3,0,2,1,13,2,3,15,14,185.3144357142857,8
76561198410539559,517,6,5,0,0,1,0,6,0,5,6,6,182.85327999999998,4
76561198125644293,571,4,2,0,0,2,0,4,0,5,4,8,453.86100000000005,3
76561198169560580,769,5,4,1,0,0,0,5,0,5,5,7,285.2979,5
76561198050425117,373,4,0,4,0,0,0,3,1,3,4,6,210.37790000000004,2
76561198142603625,610,5,4,1,0,0,0,4,1,5,5,6,85.14007500000002,4
76561198093438748,849,9,7,0,0,2,0,9,0,4,9,3,143.1178875,5
76561198078207791,456,3,1,0,0,2,0,3,0,4,3,5,218.53175000000002,4
76561198200970853,817,9,3,3,1,1,0,7,2,4,9,4,167.4899125,3
76561198258221402,807,8,7,1,0,0,0,8,0,5,8,7,161.0624571428571,3
76561198126719261,512,4,3,1,0,0,0,4,0,4,4,5,208.72103333333334,3
